------------------------------------------------------------------------------------------------------------------------------------------------------
------------------------------------------------------------------------------------------------------------------------------------------------------
------------------------------------------------------------------------------------------------------------------------------------------------------
------------------------------------------------------------------------------------------------------------------------------------------------------
------------------------------------------------------------------------------------------------------------------------------------------------------
----!!!!--------------------------------------------------------------------------------------------------------------------------------UUUU----------
------------------------------------------------------------------------------------------------------------------------------------------------------
------------------------------------------------------------------------------------------------------------------------------------------------------
--------L----------------LLooo------------------------------------------------------------------------------------------------------------------------
---------------------------ooo--g------------------------LLLLLooooo------------------o-----@----------!!!!!---oooo--------------------oo--------------
-------TT*----*------------ooo-*---SSSS--*----------y---------ooooo--------*---%-----o------------tt----------oooo----@ooooo----------oo%%%-----------
-------TT*----*----------------*--------%*--tt----tt-----------------------*--%%-----o------------tt------------*---------------------oo%%%-----------
-------TT*----**TT---tt--------*--------%*--tt%%%%tt-------tt*-------tt*---*tt%%!!!!!-------------tt-------LL---**------------tt--------%%%---r---tt--
M----%%TT*----**TT---tt--------*--o-----%*%%tt%%%%tt----k-%tt*-------tt*---*tt%%--------g----g----tt---------r-%**--r---------tt--------%%%%%%%---tt--
XXXXXXXXXX----XXXX---XXXXXXXXXXX-----XXXXXXXXXXXXXXX------XXXXXXXXXXXXXX---XXXXX---XXXXXXX--XXXXXXXXXXXXXXX----XXXXXXXXXXXXXXXXXXXXXXXXXXXXXXXXXXXXX--
XXXXXXXXXX----XXXX---XXXXXXXXXXX-----XXXXXXXXXXXXXXX------XXXXXXXXXXXXXX---XXXXX---XXXXXXX--XXXXXXXXXXXXXXX----XXXXXXXXXXXXXXXXXXXXXXXXXXXXXXXXXXXXX--
