------------------------------------------------------------------------------------------------------------------------------------------------------
------------------------------------------------------------------------------------------------------------------------------------------------------
------------------------------------------------------------------------------------------------------------------------------------------------------
------------------------------------------------------------------------------------------------------------------------------------------------------
-------------------------------------------------------------------------------------------------------------------------------------------------UUUUU
------------------------------------------------------------------------------------------------------------------------------------------------o-----
----------------------LL------------------------------------------------------------------------------------------------------------------------o-----
------------------------------------------------------------------------------------------------------------------------------------------------o-----
------------------------------------------------@@------------------UUUU--------CCCCC-----------------------------------------------------------------
---------------------------------------------------oo--o----------------k------------------------------------------g----------------------------------
--------oott-----*------y----%%---------*----------oo--o--------ooo-----tt----------------------------------------tttt----------------------------tt--
--------oott-----*----%%%%*-%%%%%%%-k---*----------oo-@oooooLLL--------*tt------------ooo--------------*--------*-tttt--r---------------*tt---tt%%tt--
--------oott--tt%*-UUU%%%%*-%%%%%%%-tt--*-----------------------*------*tt------------oo------%%%%----**--------*-tttt--*-----UUU-----*%*tt---tt%%tttt
M------y--tt--tt%*----%%%%*-%%%%%%%%tt--*---k-----y--g---------g*--k---*tt--o--------g---y----%%%%%%%%**--------*%tttt--*-------------*%*tt---tt%%tttt
XXXXXX----XXXXXXXX----XXXXXXXXXXXXXXXXXXXXXXXXXXXXXXXXXXXXXXXXX-X------XXXXXXXXXXXXXXXXXXXXXX-XXXXXXXXXXXXXXXXXXXXXXXXXXXXXXXXXXX-----XXXXX---XXXXXXXX
XXXXXX----XXXXXXXX----XXXXXXXXXXXXXXXXXXXXXXXXXXXXXXXXXXXXXXXXX-X------XXXXXXXXXXXXXXXXXXXXXX-XXXXXXXXXXXXXXXXXXXXXXXXXXXXXXXXXXX-----XXXXX---XXXXXXXX
