------------------------------------------------------------------------------------------------------------------------------------------------------
------------------------------------------------------------------------------------------------------------------------------------------------------
------------------------------------------------------------------------------------------------------------------------------------------------------
------------------------------------------------------------------------------------------------------------------------------------------------------
---------------------SSSSSS-----------------------------------------------------------CCC-------------------------------------------------------------
--------------------------------------------------------------------------------SSSSS-----------------------------------oo----------------------------
----------------ooooo---------------------------------------------------------------------------------------------------oo-----------------------!!!!!
----------------ooooo----------------------ooo----------------------------------------------------------------------------------oooo------------------
--oooUUUUUU-----ooooo----------------------ooo-------oo---------------------Coo-------------ooooo-----------------------------------------------------
--ooo----------------------ooo-----------------------ooLLLLLLLL-----o---g----oor---------k------------------------------------------------------------
--ooo-------ooo--*%%%*-----ooo---%-------------------oo-------------o---TT----%%-----k--%%%------------------------------%%%%---*----tt---------*-----
--------%---ooo--*%%%*-------tt--%--------------------------------------TT----%%tt--tt--%%%%----tt--------o------------tt%%%%---*----tt---------*--%--
--------%--------*%%%*---%%%%tt--%--------%%--k---------tt------%%---yooTT----%%tt*-tt--%%%%----tt--------o------------tt%%%%tt-*%%--tt----%%---*tt%--
My------%--k---k-*%%%*---%%%%tt-y%--------%%%%%%--------tt-----g%%---%ooTT----%%tt*-tt--%%%%----tt-----%--ogy-------g--tt%%%%tt-*%%--tt-g--%%%--*tt%--
XXXXXXXXXXXXXXXXXXXXXXXXXXXXXXXXXXXXXXXXXXXXXXXXXXXXXXXXXXXXXXXXXXXXXXXXXXXXXXXXXXXXXXXXXXXXXXXXXXXXXXXXXXXXXXXXXXXXXXXXXXXXXXXXXXXXXXXXXXXXXXXXXXXX--
XXXXXXXXXXXXXXXXXXXXXXXXXXXXXXXXXXXXXXXXXXXXXXXXXXXXXXXXXXXXXXXXXXXXXXXXXXXXXXXXXXXXXXXXXXXXXXXXXXXXXXXXXXXXXXXXXXXXXXXXXXXXXXXXXXXXXXXXXXXXXXXXXXXX--
