------------------------------------------------------------------------------------------------------------------------------------------------------
------------------------------------------------------------------------------------------------------------------------------------------------------
------------------------------------------------------------------------------------------------------------------------------------------------------
------------------------------------------------------------------------------------------------------------------------------------------------------
------------------------------------------------------------------------------------------------------------------------------------------------------
------------------------------------------------------------------------------------------------------------------------------------------------------
-----------------------------------------------ooo------ooooooooo-----------------oooooooo------------------------------------------------------------
---------------------------UUU-----------------ooo-CCCCC---------------oooo-------oooooooo-----------o---------------------------C------ooooo---------
----------------------SSS------oooo------------ooo---------------------oooo-------oooooooo----------Co-----------------------------o----ooooo---------
--------ooooo------@@---------------LLLLL----------------------------L-oooo-ooooo--------------LLLL------------ooooo---------------o-UU-ooooo---------
-----------------------------------g----------g---------*-----tt------------------------------------TT---------------@-----------------------g--------
----------TT--------------g-------%%--%-------TT--------*%%%%-tt--UU--k--------------%%%------------TTk-tt-------------------y----y-y--r----tt------%%
----------TT--%%%%--------%%------%%--%-------TT---tt---*%%%%-tt-----tt----y---------%%%---UUU--tt--TT*-tt----------g--------%%--%%%%%%%----tt--CCCC%%
M------g%%TT--%%%%g--k---r%%--r-%-%%--%--r----TT--ktt---*%%%%-tt-g%-rtt-%%%%%--------%%%--r---g-tt-gTT*-tt%---r----%%-y------%%--%%%%%%%----ttoo----%%
XXXXXXXXXXXXXXXXXXXXXXXXXXXXXXXXXXXXXXXXXXXXXXXXXXXXXXXXXXXXXXXXXXXXXXXXXXXXXXXXXXXXXXXXXXXXXXXXXXXXXXXXXXXXXXXXXXXXXXXXXXXXXXXXXXXXXXXXXXXXXX----XXXX
XXXXXXXXXXXXXXXXXXXXXXXXXXXXXXXXXXXXXXXXXXXXXXXXXXXXXXXXXXXXXXXXXXXXXXXXXXXXXXXXXXXXXXXXXXXXXXXXXXXXXXXXXXXXXXXXXXXXXXXXXXXXXXXXXXXXXXXXXXXXXX----XXXX
