------------------------------------------------------------------------------------------------------------------------------------------------------
------------------------------------------------------------------------------------------------------------------------------------------------------
------------------------------------------------------------------------------------------------------------------------------------------------------
------------------------------------------------------------------------------------------------------------------------------------------------------
-----------------------------------------------------------------------------------------------------@@@----------------------------------------------
----------------@@@---------------oo-------------------------------------------------------------------------------------!!!------------------LL------
----------------------------------ooCCCC-----------L-----------------ooooooooo---------------------------SSSS-----------------------------------------
------------!!-------------o------oo---------------------------------oooooooooCCo---------------oooo-------------------------------------o------------
---------------------------o-oooo--------LLLLLLLLL-------------UUUUU-ooooooooo--o---------------oooo-------------------------------------o--L---------
----ooooo-----o----k--!!!!-or----g----------------g-----------------------------o-----------------------g-------------------kooo---------o------------
----ooooo--r--o---%%-------%%---%%-%%*-----%%%%-%-%%----------------k------%%---------------ooo--------%%---------------g--tt------------tt--r--------
---------y-%%%%---%%-------%%-TT%%-%%*--k--%%%%-%-%%-----@@@-o----%%%%-----%%---%y-------ro----r-------%%--------------tt--tt-tt---------tt--%%-------
------%--tt%%%%---%%--%%%%-%%-TT%%-%%*-%%--%%%%-%-%%oooog---y--tt-%%%%-----%%---%tSSSS---%%-tt-tt------%%--*-----------tt--tt-tt----%%%%-tt--%%--%--%-
M--k--%--tt%%%%r--%%--%%%%y%%-TT%%-%%*-%%--%%%%-%-%%--%%%--%%-rtt-%%%%-----%%-%-%t----yoo%%gtt-tt%--k%-%%--*------%y---tt--tt-ttr---%%%%-tty-%%-k%y-%k
XXXXXXXXXXXXXXXXXXXXXXXXXXXXXXXXXXXXXXXXXXXXXXXXXXXXXXXXXXXXXXXXXXXXXXXXXXXXXXXXXXXXXXXXXXXXXXXXXXXXXXXXXXXXXXXXXXXXXXXXXXXXXXXXXXXXXXXXXXXXXXXXXX--XX
XXXXXXXXXXXXXXXXXXXXXXXXXXXXXXXXXXXXXXXXXXXXXXXXXXXXXXXXXXXXXXXXXXXXXXXXXXXXXXXXXXXXXXXXXXXXXXXXXXXXXXXXXXXXXXXXXXXXXXXXXXXXXXXXXXXXXXXXXXXXXXXXXX--XX
