------------------------------------------------------------------------------------------------------------------------------------------------------
------------------------------------------------------------------------------------------------------------------------------------------------------
------------------------------------------------------------------------------------------------------------------------------------------------------
------------------------------------------------------------------------------------------------------------------------------------------------------
------------------------------------------------------------------------------------------------------------------------------------------------------
------------------------------------------------------------------------------------------------------------------------------------------------------
------------------------------------------------------------------------------------------------------------------------------------------------------
------------------------------------------------------------------------------------------------------------------------------------------------------
------------------------------------------------------------------------------------------------------------------------------------------------------
ooo--r------k---------k----r-----------r------g---g-----g----------------------------g--g---------r--------r------g----g---------k------g-------r-----
ooo%-----g--%-g-g--g--%---%------k-----%--%-%-----%-----%------g-------r----------g-*%-*----g--r-%--k----%---%--%--%----%---r--%-%---%----------%---k-
---%---%*-*-%-%-%-%-%-%---%-%---%-g----%--%-%---%-%-----%---%--*----%-----TT---k-*%-*%-*-%-%---%-%-%-*---%---%--%--%----%--%*%-%-%-%-%----------%---%-
---%-%-%*-*-%-%-%-%-%-%--g%-%-g-%-%-%*-%--%-%---%-%-%-%-%---%--*----%---*-TT-g%-%*%-*%-*-%-%-%-%-%-%-*--*%-%-%--%*-%--%-%--%*%-%-%-%-%-%--------%-*-%-
M%-%-%-%*-*-%k%-%-%-%-%-%-%-%-%-%-%-%*-%--%-%-%-%-%-%-%-%-%-%-%*%-%-%-%-*-TT%-%-%*%-*%-*-%-%-%-%-%-%-*-%*%-%-%--%*-%--%-%--%*%-%-%-%-%-%-%--%k%-%-*-%k
XXXXXXXXXXXXXXXXXXXXXXXXXXXXXXXXXXXXXXXX-XXXXXXXXXXXXXXXXXXXXXXXXXXXXXXXXXXXXXXXXXXXXXXXXXXXXXXXXX-XXXXXXXXXXXX-XXXX-XXXX-XXXXXXXXXXXXXXXXX-XXXXXXXXXX
XXXXXXXXXXXXXXXXXXXXXXXXXXXXXXXXXXXXXXXX-XXXXXXXXXXXXXXXXXXXXXXXXXXXXXXXXXXXXXXXXXXXXXXXXXXXXXXXXX-XXXXXXXXXXXX-XXXX-XXXX-XXXXXXXXXXXXXXXXX-XXXXXXXXXX
