------------------------------------------------------------------------------------------------------------------------------------------------------
------------------------------------------------------------------------------------------------------------------------------------------------------
------------------------------------------------------------------------------------------------------------------------------------------------------
------------------------------------------------------------------------------------------------------------------------------------------------------
------------------------------ooooo---------------o---------------------------------------------------------------------------------------------------
------------------------------ooooo---------------o----------------------------------------!!!--------------------------------------------------------
------------------------------ooooo---------------o------------------------------------------------oo-------------------------------------------------
-------------------------------------------------------------oo------------------------------------oo------o------------------------------------------
--------------------------!------------------SSSS------------oo-----oooCCCC-------UUUU-------------oo------o---------UUUo-----------U-----------------
----------------------k------y-----r-------------y----------yoo------------------------L------k-------------k------------------ook----ooo-------------
---------LLL----------tt-----%%%%%%%%--%%%%----%%%%SSS------TT-----r-tt-----------tt----oo---tt----------%%%%--------------!!!!oo%%-------------------
----%%%-r------%%%%%-*tt-----%%%%%%%%--%%%%----%%%%----oooooTT--o--TTtt-tt--------tt-*--oo---tt----%%%%%-%%%%-------tt---------oo%%--g---g-----g--*--o
----%%%-*------%%%%%-*tt-----%%%%%%%%--%%%%*---%%%%---------TT-Sok-TTtt-tt--------tt-*--oo--%tt----%%%%%-%%%%----%%%tt%%%%---%%%%%%%%%--tt-----tt-*--o
M---%%%-*---%%%%%%%%-*tt---oo%%%%%%%%--%%%%*---%%%%---g---%%TT---%%TTtt-tt------g-tt-*r---g-%tt---y%%%%%-%%%%----%%%tt%%%%r--%%%%%%%%%--tt---%-tt%*--o
XXXXXXXXXXXXXXXXXXXXXXXXXXXXXXXXXXXXXXXXXXXXXXXXXXXXXXXXXXXXXXXXXXXXXXXXXXXXXXXXXXXXXXXXXXXXXXXXXXXXXXXXXXXXXXXXXXXXXXXXXXXXXXXXXXXXXXXXXXXXXXXXXXX---
XXXXXXXXXXXXXXXXXXXXXXXXXXXXXXXXXXXXXXXXXXXXXXXXXXXXXXXXXXXXXXXXXXXXXXXXXXXXXXXXXXXXXXXXXXXXXXXXXXXXXXXXXXXXXXXXXXXXXXXXXXXXXXXXXXXXXXXXXXXXXXXXXXX---
