------------------------------------------------------------------------------------------------------------------------------------------------------
------------------------------------------------------------------------------------------------------------------------------------------------------
------------------------------------------------------------------------------------------------------------------------------------------------------
------------------------------------------------------------------------------------------------------------------------------------------------------
-------------------------------------------------------------------------------------------------------------C----------------------------------------
-------------------------------C-----------------------o----------------------------------------------------------------------------------------------
----------------------------------------S---C----------o-o---------o---------------------------------!------------------------------------------------
!-----------------------------------------------o--------o---------o---------o------------------------------------U---------U-------------------------
---------------C-------------o------L---------@----------o---------o----L----o---o-!-Co----------------o------------C----------------!---------So-U---
-----------------Cy--o-------o---U----C---!r------o-----------o------------y-o-o-o----o-----U----o-----o---ko-k-----------o-------g--------S----------
---------S--!---k-%--o-------o-%--o-----%--*%-----o----*-%---yo----%-%-----%S--o------o----k-ko--o---------*o%*-----%-----o---%-L-%----o-or-----%-----
----------------%-%*-%-----%-%-%-*-----o%--*%-%-%-%--L-*-%-%-*----C%-%og---%---%-%-%---k---%-%-y!o-----%---*-%*---*-%---------%---%---r--o%-r---%----o
--o--o-Cr-----k-%-%*r%-%-%-%-%-%o*%-%-%o%-%*%-%-%-%-k-r*-%-%o*-----%-%-%-g-%-%-%-%-%-%-%-y!%-%-%-%-o-%-%-k!*-%*-y-*-%--oy-%-%-%-*-%-k-%-ro%-%-k-%----o
Myoy-oy-%-%r%-%-%-%*%%k%r%g%g%y%o*%k%y%o%y%*%k%g%y%g%-%*y%g%o*-%g%-%y%-%-%o%-%r%r%r%g%-%-%-%-%-%-%k%g%k%k%-*-%*-%o*g%g--%-%g%k%y*-%-%-%-%-%-%-%-%g%k-o
XXXXXXXXXXXXXXXXXXXXXXXXXXXXXXXXXXXXXXXXXXXXXXXXXXXXXXXXXXXXXXXXXXXXXXXXXXXXXXXXXXXXXXXXXXXXXXXXXXXXXXXXXXXXXXXXXXXXXXXXXXXXXXXXXXXXXXXXXXXXXXXXXXXX-X
XXXXXXXXXXXXXXXXXXXXXXXXXXXXXXXXXXXXXXXXXXXXXXXXXXXXXXXXXXXXXXXXXXXXXXXXXXXXXXXXXXXXXXXXXXXXXXXXXXXXXXXXXXXXXXXXXXXXXXXXXXXXXXXXXXXXXXXXXXXXXXXXXXXX-X
