------------------------------------------------------------------------------------------------------------------------------------------------------
------------------------------------------------------------------------------------------------------------------------------------------------------
------------------------------------------------------------------------------------------------------------------------------------------------------
------------------------------------------------------------------------------------------------------------------------------------------------------
-------------CCC-----------------------------------------------------oooo-----------------------------------------------------------------------------
------------------------------------------SSSSS---!------------------oooo---------------------------------------------------@-------------------------
----------------@@@-------o----------------------------U--@@@@-------oooo-----------o-----------------------------S-----------------------------------
--------------------------o---------------------@-------------o-@o------------------o-----------------------------------------------------------------
---------------------oooo-------------------------------------o--o-@---------ooooo-----------ooo-------------------oooC--@-o--------C-----------------
-----------kk--------oooo--k----------o--------y-r--ooo-y--------------------------------------------------C-------ooo-----o-o-@o----g----------------
----------ott-tt-%-%---%%%%%%---------o-o----%-%%%%-ooo-*-----%-*%---tt-------------*---!-------------------g------ooo----ko----oo--TT-------o----%--%
--------%-ott-tt*%-%---%%%%%%--%-----o---g---%-%%%%-ooo-*-----%-*%---tt*----------y-*----k------g-----------%---*-%%%%----%%%%--oo--TT-----C-o@-*-%--%
--------%-ott-tt*%-%---%%%%%%--%------%--tt--%-%%%%-%%%%*----*%-*%---tt*------%*tt%%*----%%--%%%%%%-*--L----%--%*-%%%%--o-%%%%%--o--TT---@---o--*-%--%
M------r%k-tt-tt*%-%g%-%%%%%%--%--%-r-%g-tt%-%-%%%%-%%%%*r---*%g*%k%ytt*-g--r-%*tt%%*yo%-%%--%%%%%%-*---g%--%--%*g%%%%-ro-%%%%%--%k-TTk-k-k-k---*-%--%
XXXXXXXXXXXXXXXXXXXXXXXXXXXXXXXX-XXXXXXXXXXXXXXXXXXXXXXXXXX-XXXXXXXXXXXXXXXXXXXXXXXXXXXXXXXXXXXXXXXXXXXXXX-XXXXXXXXXXXXXXXXXXXXXXXXXXXXXXXXXXX-XX-XXXX
XXXXXXXXXXXXXXXXXXXXXXXXXXXXXXXX-XXXXXXXXXXXXXXXXXXXXXXXXXX-XXXXXXXXXXXXXXXXXXXXXXXXXXXXXXXXXXXXXXXXXXXXXX-XXXXXXXXXXXXXXXXXXXXXXXXXXXXXXXXXXX-XX-XXXX
