------------------------------------------------------------------------------------------------------------------------------------------------------
------------------------------------------------------------------------------------------------------------------------------------------------------
------------------------------------------------------------------------------------------------------------------------------------------------------
------------------------------------------------------------------------------------------------------------------------------------------------------
------------------------------------------------------------------------------------------------------------------------------------------------------
------------------------------------------------------------------------------------------------------------------------------------------------------
------------------------------------------------------------------------------------------------------------------------------------------------------
LL-----------------CCCC----o-----UUUUU----------------------------------------------------------------------------------------------------------------
---------------------------o------------------------------------oooooSSSSS!----------------------------------------------------------------SSS--------
-------------------------r-o--y-------oo------------------------ooooo-------------------U@@-------LLLLL-----------------------------@@@@--------k-----
--SS----------CC--------tt-%%%--tt%%%*----k---------------------ooooott--------------------tt-----------------------r---------------------------tt----
----LL----------ooo-----tt-%%%--tt%%%*TT*tt--tt----------------*-----tt-------k------tt---*tt-------%--------------*----k------------tt---------tt*---
------tttt**tt--ooo---%%tt*%%%TTtt%%%*TT*tt%%tt-!!!!!--------tt**----tt-----k*%--UUU-tt---*tt-------%ttU-----ooo---**ttttTT----------tt%-LL-----tt*---
M-----tttt**tt--ooo---%%tt*%%%TTtt%%%*TT*tt%%tt--------------tt**----tt%%%%%%*%------tt---*tt-------%tt---k------k-**ttttTT----------tt%g-------tt*---
XXXXXXXXXXXXXXXXXXXXXXXXXXXXXXXXXXXXXXXXXXXXXXX--XXXXXXXX----XXXX----XXXXXXXXXXXXXXXXXX---XXX-------XXXXXXXXXXXXXXXXXXXXXXXXXXXXXXXXXXXX----XXXXXXXXXX
XXXXXXXXXXXXXXXXXXXXXXXXXXXXXXXXXXXXXXXXXXXXXXX--XXXXXXXX----XXXX----XXXXXXXXXXXXXXXXXX---XXX-------XXXXXXXXXXXXXXXXXXXXXXXXXXXXXXXXXXXX----XXXXXXXXXX
