------------------------------------------------------------------------------------------------------------------------------------------------------
------------------------------------------------------------------------------------------------------------------------------------------------------
------------------------------------------------------------------------------------------------------------------------------------------------------
------------------------------------------------------------------------------------------------------------------------------------------------------
------------------------------------------------------------------------------------------------------------------------------------------------------
-----------------------------------------------------------------------------------!!!!---------------------------------------------------------------
---------------------SSS------------------------------------------------------------------------------------------------------------------------------
------------------------------------------------------------------------------------------------------------------------------------------------------
-----------------------------------------------------------------o--------------------------------------------------LLLL------------oooooC------------
----------o-------------------------------------@@@@@------o--@@@o-S---ooo-------L-----r-------UUUU--------r------------------------ooooo-------------
----------o--tt------%%-k-----ooo--------------------------o@----------ooo--ooooo-k--%%%%-----------tt-----tt----------------------------------ooo----
----------o--tt------%%tto-o-r--*SS-----*-----%%%tt--------o--tt------------------%tt%%%%-----------tt-----tt-%----g----k-------%%-------------ooo---%
-------%---tttt%--tt-%%tto---*--*-------*%%%%-%%%tt------%%%--tttt--o-------------%tt%%%%-----------tt-@@@@tt-%----*%%%tt-------%%-------------ooo---%
M------%---tttt%--tt-%%ttor-y*--*--gy---*%%%%y%%%tt--ky--%%%-kttttr--y---%-k------%tt%%%%-----k--%%%tt-----tt-%----*%%%tt-r-----%%-k--%%%%%%%-----r--%
XXXXXXXXXXXXXXXXXXXXXXXXX----XXXXXXXXXXXXXXXXXXXXXXXXXXXXXXXXXXXXXXXXXXXXXXXXXXXXXXXXXXXXXXXXXXXXXXXXXXXXXXXXXXXXXXXXXXXXXXXXXXXXXXXXXXXXXXXXXXXXXXXXX
XXXXXXXXXXXXXXXXXXXXXXXXX----XXXXXXXXXXXXXXXXXXXXXXXXXXXXXXXXXXXXXXXXXXXXXXXXXXXXXXXXXXXXXXXXXXXXXXXXXXXXXXXXXXXXXXXXXXXXXXXXXXXXXXXXXXXXXXXXXXXXXXXXX
