------------------------------------------------------------------------------------------------------------------------------------------------------
------------------------------------------------------------------------------------------------------------------------------------------------------
------------------------------------------------------------------------------------------------------------------------------------------------------
------------------------------------------------------------------------------------------------------------------------------------------------------
----------------------------------------------------------------------------------!!!!!---------------------------------------------------------------
-----------------------------------------------------------------------------------------------------------------------@@---------------------@@------
-------------------------------------------------------------------------------------------@@@--------------------ooooo-------------------------oo----
-----------------------------------ooo----------------------------------------------------------------------------ooooo--------------------@----oo----
------------------------o----------ooo--------------------------------------ooo-o---------------------------------ooooo-------------------------------
------------------------o----------------LLL--g------------ooooo-----g------ooo-o-----------------------------------------k----------ooo--------------
-------------------*----o----ooo-------k--------*--y------------ooo-TT------ooo-o---**-UU----*--*--*---------*--%-----ttTT----------%%%-----SS-%------
-------------------*oo--------------tt%---------*%%*--------tt--ooo-TT---------L--tt**-------*tt*tt*---------*--%-tt--ttTT----------%%%--y-----%-%%%*-
-r-----------------*oo--------------tt%----*----*%%*--------ttTT----TT------------tt***------*tt*tt*tt-------*tt%%tt--ttTT----*-----%%%tt--%%%%%*%%%*-
M------------------*---y---------y--tt%----*----*%%*----r---ttTT----TT----g-------tt***---r--*tt*tt*tt-----r-*tt%%tt--ttTT----*-----%%%tt--%%%%%*%%%*-
XXX--------XXXXXXXXXXXXXXXXXXXXXXXXXXXX----XXXXXXXXXXXXXXXXXXXXX----XXXXXXXXXXXXXXXXXXX------XXXXXXXXXXXXXXXXXXXXXXX--XXXX----X-----XXXXX--XXXXXXXXXX-
XXX--------XXXXXXXXXXXXXXXXXXXXXXXXXXXX----XXXXXXXXXXXXXXXXXXXXX----XXXXXXXXXXXXXXXXXXX------XXXXXXXXXXXXXXXXXXXXXXX--XXXX----X-----XXXXX--XXXXXXXXXX-
