------------------------------------------------------------------------------------------------------------------------------------------------------
------------------------------------------------------------------------------------------------------------------------------------------------------
------------------------------------------------------------------------------------------------------------------------------------------------------
------------------------------------------------------------------------------------------------------------------------------------------------------
------------------------------------------------------------------------------------------------------------------------------------------------------
-------------------------ooo--------------------------------------------------------------------------------------------------------------------------
-------------------------ooo--------------------------------------------------------------------------------------------------------------------------
-------------------------ooo---------------------LLLLL---ooo-ooooo---------------------------------------------------SSSS-----------------------------
------------------------------------------------------oooooo-ooooo------------------------------------------------------------------------------------
----------------------------UUU-----------------------oooooo-----------------------SS-----------------------------------------------------------------
--CC-----------------------------------*--oo------*---ooo---o-%%%---r-----------------------SSS---@@@@@--tt---------------------------------r---------
----ooooo----------k-UUUU%-------------*--oo------*---------o-%%%---*------------------------------------tt--------------------tt%--------tt----------
-y--ooooo-----------*----%-------*-----*--------L**-----------%%%tt-*-LL------------------oo-------------tt-----------%%%------tt%--------tt--UU------
M---ooooo-----------*----%-------*-----*------r--**--------%%%%%%tt-*----k-----------g----oo---koo------ytt-------r--%%%%--y---tt%-----r--tt------k--k
XXXXXXXX-------XXXXXX----XXXX----XXXXXXX---XXXXXXXXXXXXXXX-XXXXXXXX-X---XXXXXXXXXXXX-------XXXXXXXX------XXXXXXXXXXXXXXXXXXXXXXXXXXXXXXXXXXXXXXXXXXXXX
XXXXXXXX-------XXXXXX----XXXX----XXXXXXX---XXXXXXXXXXXXXXX-XXXXXXXX-X---XXXXXXXXXXXX-------XXXXXXXX------XXXXXXXXXXXXXXXXXXXXXXXXXXXXXXXXXXXXXXXXXXXXX
