------------------------------------------------------------------------------------------------------------------------------------------------------
------------------------------------------------------------------------------------------------------------------------------------------------------
------------------------------------------------------------------------------------------------------------------------------------------------------
------------------------------------------------------------------------------------------------------------------------------------------------------
--------------------------------------------------XXXXXX----XXXXX--------------------------------------------------------------------------------XXXXX
-----------------------------------------o--------XXXXXX----XXXXX--------------------------------------------------------------------------------XXXXX
--------------------------------------XXXXXXXXXXXXXXXXXX----XXXXX--------------------------------------------------------------------------------XXXXX
-----------------------------------XXXXXXXXXXXXXXXXXXXXX----XXXXX--------------------------------------------------------------------------------XXXXX
-----------------------------XXXXXXXXXXXXXXXXXXXXXXXXXXX----XXXXX--------------------------------------------------------------------------------XXXXX
-----------------------------XXXXXXXXXXXXXXXXXXXXXXXXXXX----XXXXX--------------------------------------------------------------------------------XXXXX
----------------o------------XXXXXXXXXXXXXXXXXXXXXXXXXXX----XXXXX--------------------------------------------------------------------------------XXXXX
--------------XXXXXXXXXXX----XXXXXXXXXXXXXXXXXXXXXXXXXXX----XXXXX--------------------------------------------------------------------------------XXXXX
XXXXXXXXX--XXXXXXXXXXXXXX----XXXXXXXXXXXXXXXXXXXXXXXXXXX----XXXXX--------------------------------------------------------------------------------XXXXF
XXXXXXXXX--XXXXXXXXXXXXXX----XXXXXXXXXXXXXXXXXXXXXXXXXXX----XXXXX--------------------------------------------------------------------------------XXXXF
XXXXXXXXX--XXXXXXXXXXXXXX----XXXXXXXXXXXXXXXXXXXXXXXXXXX----XXXXX--------------------------------------------------------------------------------XXXXF
XXXXXXXXX--XXXXXXXXXXXXXX----XXXXXXXXXXXXXXXXXXXXXXXXXXX----XXXXX--------------------------------------------------------------------------------XXXXF
