------------------------------------------------------------------------------------------------------------------------------------------------------
------------------------------------------------------------------------------------------------------------------------------------------------------
------------------------------------------------------------------------------------------------------------------------------------------------------
------------------------------------------------------------------------------------------------------------------------------------------------------
------------------------------------------------------------------------------------------------------------------------------------------------------
------------------------------------------------------------------------------------------------------------------------------------------------------
-----------------------------------------------------------------------------------------oo--------------------------UU-------------------------------
-----------------------------------------------------------------------------------------oo-----------------------------------------------------------
---------------ooo-------------------------------------------------oooo------------------oo-----------------------------------------------------------
------------oo-ooo---------------ooooo-----------------------------oooo----r---------------CCCCo--------------------------------------g-----------r---
------------ooo------tt----------ooooo-------------------*---tt----oooo--%%%%------------------o---------------------tt----LLLL------tt---------%-----
-----------tt-----*--tt----------tt----------------------*-*-tt*---------%%%%tt*---*tt*----------------ooo--g--------tt%%%*----------tt---y-UU--%-----
oo---------tt----**--tttttt------tt--------!-------------***-tt*tt-----!!%%%%tt*---*tt*tt%%%%*-----ooooooo---*----%%*tt%%%*----------tttt***--@@%-----
M----------tt----**--tttttt---%%%tt-----g-----y----------***%tt*tt-------%%%%tt*---*tt*tt%%%%*---------------*----%%*tt%%%*%%%---r---tttt***----%-----
XXXXXXXXXXXXX----XX--XXXXXXXXXXXXXXXXXXXXXXXXXXXXXXXXXXXXXXXXXXXXXXXXXXXXXXXXXXX---XXXXXXXXXXXXXXXXXXXXXXXXX-X----XXXXXXXXXXXXXXXXXXXXXXXXXX----XXXXXX
XXXXXXXXXXXXX----XX--XXXXXXXXXXXXXXXXXXXXXXXXXXXXXXXXXXXXXXXXXXXXXXXXXXXXXXXXXXX---XXXXXXXXXXXXXXXXXXXXXXXXX-X----XXXXXXXXXXXXXXXXXXXXXXXXXX----XXXXXX
