------------------------------------------------------------------------------------------------------------------------------------------------------
------------------------------------------------------------------------------------------------------------------------------------------------------
------------------------------------------------------------------------------------------------------------------------------------------------------
------------------------------------------------------------------------------------------------------------------------------------------------------
------------------------------------------------------------------------------------------------------------------------------------------------------
------------------------------------------------------------------------------------------------------------------------------------------------------
------------------------------------------------------------------------------------------------oo----------------------------------------------------
------------------------------------------------------------------------------------------------ooS---------------------------------------------------
------------------------------------------------------------------------------------------------------------------------------------------------------
-------------------------------------------------------------------------k---k---------k-----------------------------------r----------g--CCCCUUUo-----
--------%%----*-------tt------------o----------tt------%-----------------tttt--------*-----LL----------tt---------------*%*-------*tt%%%%-------o-----
--------%%--g-*-------tttt--------------------*tt------%-----------------tttt--------*-----------tt----tt------------%***%*-------*tt%%%%%%-----o-----
--y-oooo%%---**-------tttt-*----UUUU------%%%%*tt------%tt%%%------------tttt---ooooo*-----------tt*---tt------r-----%***%*tt-----*tt%%%%%%-----------
M------%%%---**-------tttt-*--------------%%%%*tt------%tt%%%---y----g---tttt--------*---oo---k--tt*---tt---%%%%--oo-%***%*tt-----*tt%%%%%%-----------
XXXXXXXXXX---XXXXX----XXXX-XXXXXXXXXXXXXXXXXXXXXX------XXXXXXXXXXXXXXXXXXXXXXXXXXXXXXXXXXXXXXXXXXXXXXXXXX---XXXXXXXXXXXXXXXXXXXXXXXXXXXXXXX-----------
XXXXXXXXXX---XXXXX----XXXX-XXXXXXXXXXXXXXXXXXXXXX------XXXXXXXXXXXXXXXXXXXXXXXXXXXXXXXXXXXXXXXXXXXXXXXXXX---XXXXXXXXXXXXXXXXXXXXXXXXXXXXXXX-----------
