------------------------------------------------------------------------------------------------------------------------------------------------------
------------------------------------------------------------------------------------------------------------------------------------------------------
------------------------------------------------------------------------------------------------------------------------------------------------------
------------------------------------------------------------------------------------------------------------------------------------------------------
-------------CCC--------------------------------------------------------------------------------------------------------------------------------------
-----------------------------------------------------------------------------------------------------------ooo----------------------------------------
-----------------------------------------------oooo--------------------------------------------------------ooo----------------------------------------
---------------------------!!!---------------o-oooo--------------------------------------------------------ooo----------------------------------------
---------------------------------------------o--------------------@@----------@@@@LL------------------------------------------------------------------
ooo---------------k---------------------------------------g---------------------------r-----------------------------------y---------------------------
oooUUUUU-oooo--tt------------tt---------------C--*---------*---r------%%%----------tt----------------oCC-------r---------*-----k--*-------------------
ooo------oooo--tttt----------tt---tt%%------tt---*---k-----*tt**------%%%--------tttt%%%-------------o-------%%%%--ooooo-*---*%%%%*-ooooo*------%%%%--
--------Uoooo--tttt------@@--tttt*tt%%%%%tt*tt---**----tttt*tt**---tt*%%%--------tttt%%%-------------o-------%%%%ooooooo-*---*%%%%*-ooooo*------%%%%tt
M--------------tttt----r-----tttt*tt%%%%%tt*tt%%%**----tttt*tt**---tt*%%%--------tttt%%%-y---g--%%%------g---%%%%--ooooo-*---*%%%%*-ooooo*------%%%%tt
XXXXXXXXXXXXX--XXXX--XXXXXXXXXXXXXXXXXXXXXXXXXXXXXX----XXXXXXXXXXXXXXXXXXXXXXXXXXXXXXXXXXXXXX---XXXXXXXXX----XXXXXXXXXXXXXXXXXXXXXXXXXXX-X------XXXXXX
XXXXXXXXXXXXX--XXXX--XXXXXXXXXXXXXXXXXXXXXXXXXXXXXX----XXXXXXXXXXXXXXXXXXXXXXXXXXXXXXXXXXXXXX---XXXXXXXXX----XXXXXXXXXXXXXXXXXXXXXXXXXXX-X------XXXXXX
