------------------------------------------------------------------------------------------------------------------------------------------------------
------------------------------------------------------------------------------------------------------------------------------------------------------
------------------------------------------------------------------------------------------------------------------------------------------------------
------------------------------------------------------------------------------------------------------------------------------------------------------
------------------------------------------------------------------------------------------------------------------------------------------------------
-------------------------UUUUU------------------------------------------------------------------------------------------------------------------------
------------------------------------------------------------------------------------------@----------------------------------ooo----------------------
-----------------------------------------------------------------------------------------------------------------------------ooo----------------------
---------------------------------------------oooooC----oooo--------------------------LLLLL----------------oooo----------------------CC----------------
--------------ooo--------------------!!!-----ooooo---------!!!!!ooooo-------------------------------------oooo--------------r----LLL------------------
--------*----*ooo---------%%-----tt-------------------o*--------oooook-------------------------!!!oo--*---tt----------------%%%%----------UU----------
--------*----*ooo---------%%-----tt*----tt----*-------o*-%*-----ooooo*ooooo---------------------------*---tt-------------o--%%%%g-*-----SS--CC--------
------tt*----*------------%%-----tt*%---tt----*%%------*%%*----tt----*%%%%---*-----------tt---------***---tt--SSS-%%%%---o--%%%%*%*-----------CCCC----
M-----tt*--r-*---yy---ryk-%%--r--tt*%---tt----*%%--r---*%%*----tt%%%%*%%%%---*-----------tt-k-------***---tt------%%%%---ogg%%%%*%*---ry--------------
XXXXXXXXX----X---XXXXXX---XXXXXXXXXXX---XX----XXXXXXXXXXXXX----XXXXXXXXXXXXXXXXXXXXXXXXXXXX--XXXXXXXXXXXXXXXXXXXXXXXXXXXXXXXXXXXXXXXXXXX---XXXXXXXXXXX
XXXXXXXXX----X---XXXXXX---XXXXXXXXXXX---XX----XXXXXXXXXXXXX----XXXXXXXXXXXXXXXXXXXXXXXXXXXX--XXXXXXXXXXXXXXXXXXXXXXXXXXXXXXXXXXXXXXXXXXX---XXXXXXXXXXX
