------------------------------------------------------------------------------------------------------------------------------------------------------
------------------------------------------------------------------------------------------------------------------------------------------------------
------------------------------------------------------------------------------------------------------------------------------------------------------
------------------------------------------------------------------------------------------------------------------------------------------------------
------------------------------------------------------------------------------------------------------------------------------------------------------
ooo-LLLL----------------------!!!!!!!!--------------------------ooo------------------------------------------------------------------------CCCC-------
ooo-------------@@----------------------------------------------ooo--------------------------------------------------LLLL-----------------------------
ooo----------------------------------------------ooooo--------------------------UUUUU-----SS-------------!!-------------------------------------------
--------------------------oooo-----------------------------------------------ooo-------------oooooooo-------------------------------------------------
-------------g--------------------------g----------------@---y----------o----ooo-------k-----oooooooo--------k------r------k-oooo--r------------------
---------------*---------------%----------%---r---*-%--g------%-%----r-----r-ooo---*-----*------*----------%--%--%*-%-----*---%-----%---y---%-------k-
%-%---%-%----%-*-%---%--g------%----------%--*---%*-%---%---*-%-%---%---*--%-------*%----*--k-%-*-%----r---%--%-*%*-%---%-*---%*----%-----%-%-%--%--*-
%-%---%*%*%--%-*-%---%---tt---*%--*--*-*--%o%*-%-%*-%---%--%*-%-%--*%---*--%--%----*%----*--*-%-*-%----%---%--%-*%*-%---%-*---%*%---%*-%--%-%-%--%--*%
%-%y--%*%*%--%-*-%y--%-%-tt-%-*%-%*--*-*%-%o%*-%-%*-%---%--%*-%-%--*%---*--%--%--%-*%-%--*%-*-%-*-%--%-%-%-%--%-*%*-%-%-%-*---%*%-%-%*-%--%-%-%--%-%*%
XXXX-XXXXXX-XX-XXXX-XXXXXXXXX-XXXXX-XX-XX-X-XXXXXXXXXX-XXX-XXXXXXX-XXX-XXX-X-XXX-XXXXXXX-XXXXXXXXXX-XXXXXXXXX-XXXXXXXXXXXXXX-XXXXXXXXXXX-XXXXXX-XXXXXX
XXXX-XXXXXX-XX-XXXX-XXXXXXXXX-XXXXX-XX-XX-X-XXXXXXXXXX-XXX-XXXXXXX-XXX-XXX-X-XXX-XXXXXXX-XXXXXXXXXX-XXXXXXXXX-XXXXXXXXXXXXXX-XXXXXXXXXXX-XXXXXX-XXXXXX
