------------------------------------------------------------------------------------------------------------------------------------------------------
------------------------------------------------------------------------------------------------------------------------------------------------------
------------------------------------------------------------------------------------------------------------------------------------------------------
------------------------------------------------------------------------------------------------------------------------------------------------------
----------LL------------------------------------------------------------------------------------------------------------------------------------------
------------------------------------------------------------------------------------------------------------------------------------------------------
------------------------------------------------------------------------------------------------------------------------------------------------------
-------CC---CCCC-------------------------------------------------------------oooo---------------------------------------------------------------------
---------o---------------------------SSSS------------------------------------------------------------------------ooo---------------------oooo---------
---------o-----------------------------------------------y--------k----------------------------------------------ooo--k-------------------------------
C--------o-tt---ooooo-------CCCC---------ooo------y-----tt----oooTT-------TT--------------------------------------%%%------k---r---------tt-----------
--------*--tt*-------------------------%%ooo-------%--y-tt*------TTtt-----TT**-----*---------------ooooo-----oooo-%%%------%%%----------*tttt-----*---
--------*tttt*------------------ooooo-*%%ooo-------%TTtttt*-k----TTtt-----TT**-----*-------------------------tt---%%%------%%%----------*tttt----**---
M-------*tttt*---------g--g-%%%%ooooo-*%%-----k----%TTtttt*%-----TTtt-----TT**-----*--------k----r-----------tt---%%%---%%%%%%------y---*tttt----**---
XXXXXXXXXXXXXXXXX----XXXXXXXXXXXXXXXXXXXXXXXXXXXXX-XXXXXXXXX-----XXXXXXXXXXXXXXXXXXXXXXXXXXXXXXXXXXXXXX-XXXXXXXXXXXXX---XXXXXXXXXXXXX---XXXXX----XX--X
XXXXXXXXXXXXXXXXX----XXXXXXXXXXXXXXXXXXXXXXXXXXXXX-XXXXXXXXX-----XXXXXXXXXXXXXXXXXXXXXXXXXXXXXXXXXXXXXX-XXXXXXXXXXXXX---XXXXXXXXXXXXX---XXXXX----XX--X
