------------------------------------------------------------------------------------------------------------------------------------------------------
------------------------------------------------------------------------------------------------------------------------------------------------------
------------------------------------------------------------------------------------------------------------------------------------------------------
------------------------------------------------------------------------------------------------------------------------------------------------------
-------CCCC-------------------------------------------------------------------------------------------------------------------------------------------
-----------------------------------------------------------------------------!!!!---------------------------------------------------------------------
----------------------@@@@@---------LLL-------------------------------------------------------------------------oo------------------------------------
---------------------------------------------------------oooo---------------------------------------------------oo---------------ooo------------------
----------------oo------------------------------------------------------------------------------------------------------------------------------------
----------------oo--------------------------------------------y---------------------------------CCCCCLLLLL----------------------------------------!---
--------tt------oo-------%%-----------------U--------*%%%--*tt-----%%-----------*--------%%%--------------U--g---*--g---------*-----------------------
--------tt--------------*%%----r---------g-----------*%%%--*tt%----%%---g-------*--------%%%-----------------**--*%%---y------*--*-------------------o
--------tttt--------k--**%%ooo--tt----tt---o---------*%%%-**tt%----%%----tttttt%*--------%%%-----------------*****%%%%%-------*tt**-------------------
M-------tttt--r----%%%%**%%%%%%%tt----tt------r------*%%%-**tt%----%%----tttttt%*--------%%%--g--------------*****%%%%%%%%----*tt**---r----g-ooooo%%--
XXXXXXXXXXXX---XXXXXXXXXXXXXXXXXXX----XX---XXXXXXXXXXXXXX-XXXXXXXXXXX----XXXXXXXXXXXXXXXXXXXXXXXXXXXXXXXXXXXXXXXXXXXXXXXXXXXXXXXXXXXXXXXXXXXX-----XX--
XXXXXXXXXXXX---XXXXXXXXXXXXXXXXXXX----XX---XXXXXXXXXXXXXX-XXXXXXXXXXX----XXXXXXXXXXXXXXXXXXXXXXXXXXXXXXXXXXXXXXXXXXXXXXXXXXXXXXXXXXXXXXXXXXXX-----XX--
