------------------------------------------------------------------------------------------------------------------------------------------------------
------------------------------------------------------------------------------------------------------------------------------------------------------
------------------------------------------------------------------------------------------------------------------------------------------------------
------------------------------------------------------------------------------------------------------------------------------------------------------
------------------------------------------------------------------------------------------------------------------------------------------------------
------------------------------------------------------------------------------------------------------------------------------------------------------
--------------------------------------------ooo--------------------------SSSSS----------------------SSSSCCCCC-----------------------------------------
-------------ooo----------------------------ooo--------------!---------------------------------------------------------------------------ooo----------
---------!!----------oooooo-----------------ooo----------C---------------------------------------@@@-------------------------------------oooCCC-ooooC-
---o-----------------oooooo------------------------------------------------------------------oooo----------------------------------------ooo---------r
---o----------------@--%%%o--------tt--r-----tt---------k-ooo-------------tt------------*-----*-----%*-*--------------*------------------------k-----%
------------ytt--------%%%---------tt-ttkr%y*tttt-------%%ooo-oo--oo----tttt--g---------*-----*-----%*-*--------------*------%%--------g------*tt----%
------------*tt--------%%%-LLL-----tt%tttt%**tttt-------%%ooo*oooooo----tttt*%%tt-------*-----*-----%*-*----*---------*----tt%%*------%%%%*---*tt%%%*%
M-------r--r*tt-kygy---%%%---------tt%tttt%**tttt------g%%---*----------tttt*%%tt-------*-ryk-*%%%--%*-*----*g--%%%-g-*----tt%%*------%%%%*---*tt%%%*%
XXXXXXXX----XXXXXXXXXXXXXXXXXXXXXXXXXXXXXXXXXXXXXXXXXXXXXX---XXXXXXXXXXXXXXXXXXXX-------XXXXXXXXXX--XX-X----X---XXXXXXXXXXXXXXXX-XXXXXXXXXX---XXXXXXXX
XXXXXXXX----XXXXXXXXXXXXXXXXXXXXXXXXXXXXXXXXXXXXXXXXXXXXXX---XXXXXXXXXXXXXXXXXXXX-------XXXXXXXXXX--XX-X----X---XXXXXXXXXXXXXXXX-XXXXXXXXXX---XXXXXXXX
