------------------------------------------------------------------------------------------------------------------------------------------------------
------------------------------------------------------------------------------------------------------------------------------------------------------
------------------------------------------------------------------------------------------------------------------------------------------------------
------------------------------------------------------------------------------------------------------------------------------------------------------
------------------------------------------------------------------------------------------------------------------------------------------------------
------------------------------------------------------------------------------------------------------------------------------------------------------
-------------CC-----------------------------------------------------------------------oooo-------------------ooo--------------------------------------
------------------------!!!!!---------------------------------------------------------oooo--UUU--------------ooo------------------------------------oo
------------------o-------------------------------------------------------------------oooo----------------------------------UUUU----------------------
----------------g-o-------------------------------------------------------------Looooo----------g-------------------------------------------g-----k---
-----------------*o---------------------------------%%%-------------------------------*----------*-----g--------o---------oo------y---------*%%%tt--tt
------ooo----tt--*--------tt----%%%--CCCC-----g--tt-%%%--------SSSSS-%%----------%%*--*----------*--%%%%-----tt--U--------oo--*tt-----------*%%%tt--tt
----ttooo----tttt*--------tt----%%%----------%%%%tt*%%%--------------%%----------%%*%%*---o------*--%%%%%%%tttt---ooooo-----tt*tt-----------*%%%tttttt
M---ttooo-%%%tttt*---k----tt----%%%%%--------%%%%tt*%%%%%%-----------%%-------r--%%*%%*-----%%---*--%%%%%%%tttt---oooo--g---tt*tt-----y-ooo-*%%%tttttt
XXX-XX----XXXXXXXX---XXXXXXX----XXXXXXXXXXXXXXXXXXXXXXXXXXXXXXXXXXXXXXX----XXXXXXXXXXXXXXXXXXXXXXX--XXXXXXXXXXXXXXXXXXXXXXXXXXXXX----XXXXXXXXXXXXXXXXX
XXX-XX----XXXXXXXX---XXXXXXX----XXXXXXXXXXXXXXXXXXXXXXXXXXXXXXXXXXXXXXX----XXXXXXXXXXXXXXXXXXXXXXX--XXXXXXXXXXXXXXXXXXXXXXXXXXXXX----XXXXXXXXXXXXXXXXX
