------------------------------------------------------------------------------------------------------------------------------------------------------
------------------------------------------------------------------------------------------------------------------------------------------------------
------------------------------------------------------------------------------------------------------------------------------------------------------
------------------------------------------------------------------------------------------------------------------------------------------------------
----------------------@-----------------------------------------------------UUU-----------------------------------------------------------------------
--------------------------------------@@@-------------------------------------------------------------------------------------------------------------
------------------------------------------------------------------------------------------------------------------------------------------------------
-----------------------o----------------------------------o-----------------------------------oooo-----------------------------------LLL--------------
-----------------------------------------SS---------------o-----oo--------------------@@@@@---oooo-------------------------------------------oo@@@@---
-----------------UUUU---r-------------------------------------LLoo--------------g----r--------------------!!----------------------------g-------------
---------------------k***--------ooooo--%%---LLL-------%--------oo------------tt%tt--%------------%%-%%%---------------oooo-------tt---tt-------------
-----------%----r--%%%***!-------ooooo--%%-------*---tt%tt*-------------------tt%tt--%----------tt%%*%%%------tt%%%%CCCoooo-----tttt---tt-----tt------
--------yy-%----tt-%%%***-g--------tt---%%-oo%---*--*tt%tt*-------------------tt%tt--%-----LLL--tt%%*%%%------tt%%%%------------tttt---tt--*--tt------
M-------%%%%%%%%tt-%%%***%%oooooy--tt---%%---%---*--*tt%tt*ooo---------%rooo--tt%tt--%----------tt%%*%%%------tt%%%%------------tttty--tt--*--tt------
XXXXXXXXXXXXXXXXXX-XXXXXXXX---XXXXXXX---XXXXXXXXXXXXXXXXXXX----XXXXXXXXX---XXXXXXXX--X---XXXXXX-XXXXXXXXXXXXXXXXXXXXXXXXXXXXXXXXXXXX---XX--X--XXXXXXXX
XXXXXXXXXXXXXXXXXX-XXXXXXXX---XXXXXXX---XXXXXXXXXXXXXXXXXXX----XXXXXXXXX---XXXXXXXX--X---XXXXXX-XXXXXXXXXXXXXXXXXXXXXXXXXXXXXXXXXXXX---XX--X--XXXXXXXX
