------------------------------------------------------------------------------------------------------------------------------------------------------
------------------------------------------------------------------------------------------------------------------------------------------------------
------------------------------------------------------------------------------------------------------------------------------------------------------
------------------------------------------------------------------------------------------------------------------------------------------------------
----------------------------------------------------------------------------------------------CCC-----------------------------------------------------
------------------------------------UUUU--------------------------------------------------------------------------------------------------------------
---------ooo-------------------------------------o---------------------------------------------------------------------------------------ooo----------
-------ooooo-------------------------------------oLL--------------------------------------------------------------------------------------------------
-------ooooo-------------------------------------------------------!!!!!------------------------------------------------------------------------U-----
------C--------@LUUU--r------ooo--------------------------------------------------------------------------k----ooooo--------------------------r-------
-------------*--------tt-----ooo--------------r--%%---g----------*----------------------------%---r--------%---ooooo----UU----------------%%%%--------
--------*%%%%*%%%-----tt*--r----ooo--*----y--*---%%**----------tt*%--------ooo--------------r-%tt*---------%---*%%----r-------------------%%%%------*-
--------*%%%%*%%%---tttt*tt-----ooott*----*--*%%*%%**---ooooo--tt*%--------------------------*%tt*--------*%---*%%%%%--------------g------%%%%------*%
M-------*%%%%*%%%---tttt*tt--------tt*%%%%*--*%%*%%**---ooooo--tt*%------y--------------y----*%tt*--------*%---*%%%%%--------------%%%%---%%%%------*%
XXXXXXXXXXXXXXXXX---XXXXXXXXXXXXXXXXXXXXXXX--XXXXXXXXXXXXXXXX--XXXXXXXXXXXXXXXXXXXXXXXXXX----XXXXXXXXXXXXXXXXXXXXXXXXXXXX----XXXXXXXXXX---XXXXXXXX--XX
XXXXXXXXXXXXXXXXX---XXXXXXXXXXXXXXXXXXXXXXX--XXXXXXXXXXXXXXXX--XXXXXXXXXXXXXXXXXXXXXXXXXX----XXXXXXXXXXXXXXXXXXXXXXXXXXXX----XXXXXXXXXX---XXXXXXXX--XX
