------------------------------------------------------------------------------------------------------------------------------------------------------
------------------------------------------------------------------------------------------------------------------------------------------------------
------------------------------------------------------------------------------------------------------------------------------------------------------
------------------------------------------------------------------------------------------------------------------------------------------------------
--------------------------------------------------------------------------------------------------UUU-------------------------------------------------
------------------------------------------------------------------------------------------------------------------------------------------------------
---------------------------------------------------------------------------------------------------------------------------------------LLLLL----------
---------------------------------------LSSSS------------------------------------------------------------------------------------------------@@@@------
--------------------------------LLL-----------------------------------LLLLL-----------------------------------------ooooo-----------------------------
-------------g--g------------r--------------o----------------------------------------------------@------------------ooooo-----------ooo---------!!----
--------------tt--------------*----------*--o---------------------o---%%------------------------o-*---------tt------ooooo--------------------TT-----g-
------LLLLL--*tt--------tt----*%*----r---*--o--UUU------y-------tt----%%----g---------*---------o-**--------tt---------*-------------------ttTT---tt--
ooooCC------**tt-------*tt%%%%*%*%%%---tt*--------------tt-----*tt----%%---tt---------*---------o-**--------tt%--------*-ooo-r---y--------%ttTT---tt--
M-----------**tt-------*tt%%%%*%*%%%---tt*----------y---tt-----*tt%%%%%%---tt---------*-----------**---y----tt%--------*------%%%%%%%%----%ttTT---tt--
XXXXXXXXXXXXXXXXXXXXXX-XXXXXXXXXXXXX---XXXXXXXXXXXXXXXXXXX-----XXXXXXXXXXXXXXXXXXX----X-XXXXXXXXXXXX--XXXXXXXXXXXXXXXXXXXXXXXXXXXXXXXXXXXXXXXXX---XX--
XXXXXXXXXXXXXXXXXXXXXX-XXXXXXXXXXXXX---XXXXXXXXXXXXXXXXXXX-----XXXXXXXXXXXXXXXXXXX----X-XXXXXXXXXXXX--XXXXXXXXXXXXXXXXXXXXXXXXXXXXXXXXXXXXXXXXX---XX--
