------------------------------------------------------------------------------------------------------------------------------------------------------
------------------------------------------------------------------------------------------------------------------------------------------------------
------------------------------------------------------------------------------------------------------------------------------------------------------
------------------------------------------------------------------------------------------------------------------------------------------------------
---------------------------------------------------------!!!------------------------------------------------------------------------------------------
---------CCC------------------------------------------------------------------------------------------------------------------------------------------
------------!!!---------------------------------------------------SSSSS--------------------------o----------------------------------------------------
--------------------------------------------SSSSS-----ooo---------------------------------------------------------------------------------------------
------------------UUUU---------------------------oo-------------------------------------------------------------------------ooooo---------------------
-o-----------------------------------------------------------------------------o---------------------------k------!------------------------CCC-----g--
oo------tt*--*--g------------ttoooo-----------*-----oo--tt---k----------%%tt------------ooo----%%%---------*---g-----------%------------------ooo--%%%
--------tt*--*tt%%%%---------ttoooo%----------*-----oo--tt----*---------%%tt-----*tt-----------%%%------r--*----%*-------tt%-*----------------ooo--%%%
--------tt*--*tt%%%%-------ttttoooo%-*-------**---tt----tt----*-------tt%%tt-----*tt-------o---%%%-------tt*----%*-------tt%**----------------ooo--%%%
M-------tt*--*tt%%%%-------tttt----%-*-------**---tt%%%%tt----*-r-----tt%%tt%%%%%*tt-----------%%%-------tt*%%%%%*---r---tt%**---------------------%%%
XXXXXXXXXXX--XXXXXXXXXXXXXXXXXXXXXXX-X-XXXXXXXXXXXXXXXXXXX----XXXXXXXXXXXXXXXXXXXXXX---XXXXXXXXXXXXXXXXXXXXXXXXXXXXXXXXXXXXXXXXXXX-XXXXXXXXXXXXXXXXXXX
XXXXXXXXXXX--XXXXXXXXXXXXXXXXXXXXXXX-X-XXXXXXXXXXXXXXXXXXX----XXXXXXXXXXXXXXXXXXXXXX---XXXXXXXXXXXXXXXXXXXXXXXXXXXXXXXXXXXXXXXXXXX-XXXXXXXXXXXXXXXXXXX
