------------------------------------------------------------------------------------------------------------------------------------------------------
------------------------------------------------------------------------------------------------------------------------------------------------------
------------------------------------------------------------------------------------------------------------------------------------------------------
------------------------------------------------------------------------------------------------------------------------------------------------------
------------------------------------------------------------------------------------------------------------------------------------------------------
-------------------------------------------------------------------------------oooo---------------------------------------------------!!--------------
----------------------------------------------------------------LLLLL----------oooo-------------------------------------------------------------------
----------------------------------------oooUU----LL----------------------------oooo----------------------------------SS-----------------!-------------
---------------oooo----------------UUUUU-----SSSS-------!!!!!---------------------------------------------ooo-----------------------------------------
-----------------------------------------------------y-----------------------r--------------!ooo----------ooo-----------------------------------------
----------%%%%-------r----------%%%-------%--*----tt-------tt-----------------%tt*------------------------ooo--------------------------------*-%------
SSS-------%%%%--%%%%%-----------%%%*------%--*----tt-------tt-r--------tt-----%tt**-----------------------*------------------------r---tt----*-%tt%-TT
----------%%%%--%%%%%%%---------%%%*------%tt*----tt-------tt**---tt---tt-@@--%tt**-----------tt%%%-------*-------%%%%%%------*tt----tttt----**%tt%-TT
M----r----%%%%--%%%%%%%---------%%%*------%tt*----tt---o---tt**%%%tt---tt-----%tt**%%%--------tt%%%-------*-------%%%%%%------*tt----tttt----**%tt%%TT
XXXXXXXXXXXXXX--XXXXXXX-XXXXXXXXXXXXXXXXXXXXXXXXXXXX--XXXXXXXXXXXXXX---XXXXXXXXXXXXXXXXXXX----XXXXX-------XXXXXXXXXXXXXX---XXXXXXXXX-XXXX----XXXXXXXXX
XXXXXXXXXXXXXX--XXXXXXX-XXXXXXXXXXXXXXXXXXXXXXXXXXXX--XXXXXXXXXXXXXX---XXXXXXXXXXXXXXXXXXX----XXXXX-------XXXXXXXXXXXXXX---XXXXXXXXX-XXXX----XXXXXXXXX
