------------------------------------------------------------------------------------------------------------------------------------------------------
------------------------------------------------------------------------------------------------------------------------------------------------------
------------------------------------------------------------------------------------------------------------------------------------------------------
------------------------------------------------------------------------------------------------------------------------------------------------------
------------------------------------------------------------------------------------------------------------------------------------------------------
--------------------------------------------------------UUU--------------------------------------!!!!!------------------------------------------------
------------------------------------------------------------------------------------------------------@@@@@-------------------------------------------
------------------------------------------------------------------------------------------------------------------------------------------------------
-----------ooooo---------------------------------o@@@@oo------------------------------------CCCCC-----------------------------------------------------
CCCCC------ooooo--r----------------------------r-o----oo----------------------------------oo------------------------------------------------r---------
-----------tt------tt!!!-----------------y--y-*------------SS-----------------------------oo---------%-%%%%----------------------%-TT--------tttt----t
-----------tt------tt---------------------%%%%*tttt*--%%%--------------------------%%%%--------------%-%%%%tt***-----------------%*TT--------tttt----t
-----------tttt----tt-----------*--------%%%%%*tttt*tt%%%----------*---------------%%%%-----------%%%%-%%%%tt***---------------*-%*TTooooo---tttt----t
M----------tttt----tt-----------*--------%%%%%*tttt*tt%%%----------*---------%%%%%%%%%%-----------%%%%-%%%%tt***---------------*-%*TT-%%%----tttt--k-t
XXXXXXXXXXXXXXXXXXXXX----XXXXXXXXXXXXXXXXXXXXXXXXXXXXXXXX--XXXXXXXXX----XXXXXXXXXXXXXXX---XXXXXXXXXXXX-XXXXXXXXX----XXX--XXXXXXX-XXXX-XXXXXXXXXXX----X
XXXXXXXXXXXXXXXXXXXXX----XXXXXXXXXXXXXXXXXXXXXXXXXXXXXXXX--XXXXXXXXX----XXXXXXXXXXXXXXX---XXXXXXXXXXXX-XXXXXXXXX----XXX--XXXXXXX-XXXX-XXXXXXXXXXX----X
