------------------------------------------------------------------------------------------------------------------------------------------------------
------------------------------------------------------------------------------------------------------------------------------------------------------
------------------------------------------------------------------------------------------------------------------------------------------------------
------------------------------------------------------------------------------------------------------------------------------------------------------
------------------------SSSSS-------------------------------------------------------------------------------------------------------------------------
----------------------------------------------------------------------------------------------CC------------------------------------------------------
------------------------------------------------------------------------------------------------------------------------------------------------------
------------------------------------------------------------------------------------------------LLLLL-----ooooo---------------------------------------
---------------------------------------------------UUU------------------------------------------------oooooooooU------------oooo----------------------
-------------------------------------------ooooo--------oooCCCC--r--ooo-----------------------------------------------------oooo-------oo-------------
-----------------tt------%%--------%%*-------*----------ooo------*-*ooo---------oo--------SSSS--------------*---------------oooo----------------------
-----------------tt%----*%%--L-----%%*-------*--------oo---------***---!!----UUUoo-------o-----tt---------*-*-------------------------tt---%----------
--r------------%-tt%----*%%--------%%*-------*--UUU---oo*--------***------------oo%------o-----tttt---tt--***---%*------------------tttt---%----------
M--------------%-tt%--y-*%%--------%%*--r----*--------oo*--------***--------------%%%%---------tttt---tt--***---%*------------------tttt---%--g-------
XXXXXXXXXXXXXXXX-XXX----XXXXXXXXXXXXXXXXXXXXXXXXXX--XXXXXXXXXXXXXXXXXXXXXXX--XXXXXXXXXXXXXXXXXXXXXX---XX--XXX---XXXXXXXXXX----XXXXXXXXXXXXXXXXXXXXXXXX
XXXXXXXXXXXXXXXX-XXX----XXXXXXXXXXXXXXXXXXXXXXXXXX--XXXXXXXXXXXXXXXXXXXXXXX--XXXXXXXXXXXXXXXXXXXXXX---XX--XXX---XXXXXXXXXX----XXXXXXXXXXXXXXXXXXXXXXXX
