------------------------------------------------------------------------------------------------------------------------------------------------------
------------------------------------------------------------------------------------------------------------------------------------------------------
------------------------------------------------------------------------------------------------------------------------------------------------------
------------------------------------------------------------------------------------------------------------------------------------------------------
------------------------------------------------------------------------------------------------------------------------------------------------------
---------------------------------------UUU------------------------------------------------------------------------------------------------------------
------------------------------------------------------------------------------------------------------------------------------------@-----------------
-----------------------ooooo----------------@@@@@--------------------------------------LLLLL----------------------------------------------------------
-----------------------ooooo------ooooo----------LLL-------------------------oooSSS-SS------LLLoooo---------------------------------------------------
---------L-------------ooooo---!!-ooooo-----------------------------oo------------------------------------------------------------------g------@@@@---
-----------------UUUUg-*----------tt---------------*--tt------o-----oo---------tt---tt--%---%---%%--------------------------------TT%---tt------------
-----------%----y----*y*----------tt---%%-------*tt*tttttt*---o---@@oo---------tt---tt--%---%-tt%%*%%%------tt---------oooo-------TT%UUUtt------------
--------y--%----tt-tt***----------tt---%%-oo%---*tt*tttttt*----ooo-------------tt---tt--%---%-tt%%*%%%------tt------LLLoooo-------TT%---tt--*--tt-----
M-------%%%%%%%%tt-tt***%%--rrk--gtt---%%---%---*tt*tttttt*----ooo----------r--tt%%%ttk-%---%-tt%%*%%%-----ott%%%%----------------TT%---tt--*oott-----
XXXXXXXXXXXXXXXXXX-XXXXXXX---XXXXXXX---XXXXXXXXXXXXXXXXXXXX----XXXXXXXXXX---XXXXXXXXXX--X---X-XXXXXXXXXXXXXXXXXXXXXXXXXXXXXXXXXXXXXXX---XX--X--XXXXXXX
XXXXXXXXXXXXXXXXXX-XXXXXXX---XXXXXXX---XXXXXXXXXXXXXXXXXXXX----XXXXXXXXXX---XXXXXXXXXX--X---X-XXXXXXXXXXXXXXXXXXXXXXXXXXXXXXXXXXXXXXX---XX--X--XXXXXXX
