------------------------------------------------------------------------------------------------------------------------------------------------------
------------------------------------------------------------------------------------------------------------------------------------------------------
------------------------------------------------------------------------------------------------------------------------------------------------------
------------------------------------------------------------------------------------------------------------------------------------------------------
------------------------------------------------------------------------------------------------------------------------------------------------------
---------------------------------------------------------------------------------------------------@@@@-----------------------------------------------
-------------------------------------ooooo-------------------------------------------------------------------------------------------ooooo------------
------------------------------oooo--L-------------@@@-------LLLL-------------------------------------------------------------------ooooooo-------oo---
------------------------------oooooo--------------------------------------------------------------------------------ooLL--ooooo------------------oo---
--------oooooCCCC!!!!oooo-------------------------------------------------------------------------------------------oo--oo------ooo--------------oo---
ooooo---ooooo--------oooo---oo--*tt-%%%%--oo*%%%%-*----------*-%-----------g-----*----------------------------------oo--oo------ooo-----------LLL-----
ooooo------------*--------r-oo--*tt-%%%%--oo*%%%%-*----------**%---%-------tt----*-ooo-----oo----g--%%----------------ttoo*----oooo%%%-tt-------------
-----------------*--------tt----*tt*%%%%----*%%%%%*--------tt**%---%-------ttU---*-oooSSSSS-------%%%%---------------*tt--*--------%%%-tt-------tt--g-
M----------------*--------tt%%%%*tt*%%%%----*%%%%%*--------tt**%---%--ooo--tt----*-ooo--------g---%%%%----%%%--------*tt%%*--------%%%-tt-o-----tt%%--
XXXXXXXXXXXXXXXXXXXXXXXXXXXXXXXXXXXXXXXX----XXXXXXXXXXXXXXXXXXXX---XXXXXXXXXX----X----XXXXXXXXXXXXXXXX----XXXXXXXXXXXXXXXXXXXXXXXXXXXX-XXXXXXXXXXXXXXX
XXXXXXXXXXXXXXXXXXXXXXXXXXXXXXXXXXXXXXXX----XXXXXXXXXXXXXXXXXXXX---XXXXXXXXXX----X----XXXXXXXXXXXXXXXX----XXXXXXXXXXXXXXXXXXXXXXXXXXXX-XXXXXXXXXXXXXXX
