------------------------------------------------------------------------------------------------------------------------------------------------------
------------------------------------------------------------------------------------------------------------------------------------------------------
------------------------------------------------------------------------------------------------------------------------------------------------------
------------------------------------------------------------------------------------------------------------------------------------------------------
----------------------------------------------------------------------------------------------------------------------CCCCC---------------------------
------------------------------------------oo------------------------------SSSS------------------------------------------------------------------------
------------------------------------------oo------LLLLL-------------------------------------------------------@-----------------LLL-------------------
-----------------------------------------------------------------------------------------------------------@@@-----------------------LL--------CCCC---
------------------------oooo----------@@@@--ooooo----------------------------------oooo---------------------------------------------------------------
--------oo-------------------ooooo----------ooooo----------------------------------oooo------------------------------------------------CCC---------r--
-----tt-oo-------------tt--*-ooooo---------%%%----------------o--SS------ytt-------oooo----------------------%%ooo-tt-----TT-------------------tt--tt-
-----tt-------%--------tt--*-ooooo---------%%%----*-----------o--------*tttt---------------------------------%%ooo-tt----%TT-----TT--tt-----g-*tt--tt-
-----tt-------%----%%%%tt--*--------@@-----%%%%%%-*---------ooo--------*tttt---ooo--*----%%%%-------ooooooo--%%----tt----%TT-----TT%%tt*----%%*tt--tt%
M----ttk------%----%%%%tt--*k-----yr-------%%%%%%-*----y----oo--y------*tttt--g---g-*----%%%%------y-%%%%----%%----tt----%TT-----TT%%tt*--kg%%*tt%%tt%
XXXXXXXXXXXXXXXXXXXXXXXXX--XXXXX-XXXXXXXXXXXXXXXX-XXXXXXXXXXXXXXXXXXXXXXXXXX----XXXXXXXXXXXXXXXXXXXXXXXXXXXXXXX----XXXXXXXXX-----XXXXXXX----XXXXXXXXXX
XXXXXXXXXXXXXXXXXXXXXXXXX--XXXXX-XXXXXXXXXXXXXXXX-XXXXXXXXXXXXXXXXXXXXXXXXXX----XXXXXXXXXXXXXXXXXXXXXXXXXXXXXXX----XXXXXXXXX-----XXXXXXX----XXXXXXXXXX
