------------------------------------------------------------------------------------------------------------------------------------------------------
------------------------------------------------------------------------------------------------------------------------------------------------------
------------------------------------------------------------------------------------------------------------------------------------------------------
------------------------------------------------------------------------------------------------------------------------------------------------------
------------------------------------------------------------------------------------------------------------------------------------------------------
------------------------------------------------------------------------------------------------------------------------------------------------------
-------------------------------------------------oooo-------------------------------------------------------------------------------------------------
---------SSSS----------SSSSS---------------------oooo----------------------------------------------------------------------------------------------ooo
---------------------------------LLL-------------oooo-------------------------CCC------------------------------------------------------------------ooo
---------------y----------------@--------------y---------------------------k----------------------------------------------k----g-----------------r-ooo
-----k----%%%%-------%%%%----------------------%%%tt----------ooo------k---tt-----------oooo-tt--------------------y--k-tt----*-----------------tt----
------%--*%%%%--tt---%%%%---LLLL---------------%%%tt---------%%%----tt--tt-tt------------*---tt%-------*------------tt--tt--tt*--!!!------------tt-*--
--g---%!!*%%%%--tt%--%%%%*---------TT---ooooo--%%%tt*tttt----%%%*---tt--tt-tt---tt-------*---tt%--*----*%%%---------tt*-tt--tt*------------SSSS-tt-*--
M-----%--*%%%%%%tt%--%%%%*---------TT---ooooo--%%%tt*tttt----%%%*---tt%%tt%tt---tt-------*---tt%--*----*%%%----k----tt*-tt--tt*------k---y------tt%*--
XXXXXXX--XXXXXXXXXX--XXXXXXXXXXXXXXXX-XXXXXXXXXXXXXXXXXXX----XXXX---XXXXXXXXX---XX--XXXXXX---XXX--XXXXXXXXXXXXXXXXXXXXX-XX--XXX--XXXXXXXX-------XXXXXX
XXXXXXX--XXXXXXXXXX--XXXXXXXXXXXXXXXX-XXXXXXXXXXXXXXXXXXX----XXXX---XXXXXXXXX---XX--XXXXXX---XXX--XXXXXXXXXXXXXXXXXXXXX-XX--XXX--XXXXXXXX-------XXXXXX
