------------------------------------------------------------------------------------------------------------------------------------------------------
------------------------------------------------------------------------------------------------------------------------------------------------------
------------------------------------------------------------------------------------------------------------------------------------------------------
------------------------------------------------------------------------------------------------------------------------------------------------------
--------!!!!!-----------------------------------------------------------------------------------------------------------------------------------------
-------------------------------------------------------------------------------------------------------------------SSSS---------ooo-------------------
-------------------LLLL------------------@@-------------------------------------------------------------------------------------ooo!!!!!--------------
---------------------------------------------------------------------------------------------------------------!!!!-----------------------------------
-------------LLLL------------ooooo----UUU------------------------------------------------------------------------------SSSSS--------------------------
------------------------g--r-ooooo----------------------------y----------------------------------------!!!------------------------------!-------------
---------tt--------------%%%--tt--oooo---%--------------------*-o------------------tt-------!!!-*--------------*----------%%oo---tt--***------------y-
-------tttt-------tttt---%%%tttt---------%----------------y--**-o------------------tt-----!!----*--------------*----%%%---%%oo---tt--***--------k--%--
-------tttt-------tttt---%%%tttt---------%--------oooo-----%%**-o-----------oo---tttt---------tt*TT----*-----@@*----%%%%%%%%-----tt--***-------*---%%%
M------tttt-------tttt---%%%tttt---------%------k-oooo-r---%%**----------g-----g-tttt---r-----tt*TT----*---r---*%%%%%%%%%%%%-----tt--***---k---*---%%%
XXXXXXXXXXX-------XXXX---XXXXXXXXXXXXXXXXXXXXXXXXXXXXXXXXXXXXXX---XXXXXXXXXXXXXXXXXXXXXXXXX---XXXXXXXX-XXXXXXXXXXXXXXXXXXXXX--XXXXX--XXX--XXXXXX---XXX
XXXXXXXXXXX-------XXXX---XXXXXXXXXXXXXXXXXXXXXXXXXXXXXXXXXXXXXX---XXXXXXXXXXXXXXXXXXXXXXXXX---XXXXXXXX-XXXXXXXXXXXXXXXXXXXXX--XXXXX--XXX--XXXXXX---XXX
