------------------------------------------------------------------------------------------------------------------------------------------------------
------------------------------------------------------------------------------------------------------------------------------------------------------
------------------------------------------------------------------------------------------------------------------------------------------------------
------------------------------------------------------------------------------------------------------------------------------------------------------
-------------------------------------------------------SSS-------------------------------------------------------------------------------------------U
----------------------------------------------------------UUUUU----------LLLLL!!!!!-------------------------------------------------------------------
---------------------------------------------------------------------------------------------------------------------------CCC------------------------
---------------------oo--------------------------LLLLLo-----------------------------------------------------------------------------------------------
---------------------oo-------------------------------------------------------------------------------------------------------------------------------
-------L----------------------------------------g---------------------UUU------------------------------------------------------------UUUUoooo---------
----ook--------------------tt-------------------tt----%%%%-------------------%%---------------------------------------ooCCC-----------------tt%%%-%%%%
----oo%%%%--------!!-------tt-------oo--------tttt----%%%%-tt%%%-------------%%-tt------------------------------------oo---tt-oooo----------tt%%%*%%%%
--@---%%%%-----------*-----tt-----CCoo--------tttt----%%%%-tt%%%-------------%%-tt%%%tt------!!!----------------------oo--*tt-ooooLLL-------tt%%%*%%%%
Mk-y--%%%%----------k*-oo--tt-------oo--------tttt----%%%%-tt%%%-------------%%-tt%%%tt---------------------------gr------*tt-oooo----------tt%%%*%%%%
XXXXXXXXXX--XXXXXXXXXXXXXXXXXXXXXXXXX---XXX---XXXX----XXXX-XXXXXXXXXXXX------XX-XXXXXXX---XXXX----XXXX-------XXXXXXXXXXXXXXXX-------XXXXXXXXXXXXXXXXXX
XXXXXXXXXX--XXXXXXXXXXXXXXXXXXXXXXXXX---XXX---XXXX----XXXX-XXXXXXXXXXXX------XX-XXXXXXX---XXXX----XXXX-------XXXXXXXXXXXXXXXX-------XXXXXXXXXXXXXXXXXX
