------------------------------------------------------------------------------------------------------------------------------------------------------
------------------------------------------------------------------------------------------------------------------------------------------------------
------------------------------------------------------------------------------------------------------------------------------------------------------
------------------------------------------------------------------------------------------------------------------------------------------------------
----------------------------------------------------------------------SSSS!!!!------------------------------------------------------------------------
------------------------------------------------ooo---------------------------------------------------------------------------oo-S--------------------
-----oo-----------------------------ooooo-------ooo-----------------------------oooo------------------------------------------oo----------------------
------------------------------------ooooo-------ooo-----------------------------oooo------------------------------------------oo---------------------!
CCCCC--------------------UUU--------ooooo---------------------------------------oooo--------------------------------------CCCC------------------------
----------------oo------------------------r------------------------k----------@@----------------------------------------------------------------------
------*---------oo-------------------*--tt------------------------TT----%%*---------------%%%--*------------%TT--------------%%%----y--!----------r---
------*----ooooo---------------------*--tt-------tt-------tt------TT----%%*%%%%%%%-----tt-%%%--*%%%---------%TT--------tt----%%%-*tt----------------TT
------*----*--------------------oooo-*tttt-------tt!!!!!--tt------TT----%%*%%%%%%%----%tt*%%%--*%%%---------%TT--------tt----%%%-*tt%%%%-------@---*TT
M-----*----*------------------k------*tttt----g--tt-------tt------TT----%%*%%%%%%%----%tt*%%%-%*%%%------y--%TT--------tt----%%%o*tt%%%%--k--------*TT
XXXXXXXXXXXXXXXXXXXXXXXXXXXXXXXXXXXXXXXXXXXXXXXXXXXXXXXXXXXXXXXXXXXXXXXXXXXXXXXXXX----XXXXXXX-XXXXXXXXXXXXX-XXXXXXXXXXXXX----XXX-XXXXXXXXXXX---XXXXXXX
XXXXXXXXXXXXXXXXXXXXXXXXXXXXXXXXXXXXXXXXXXXXXXXXXXXXXXXXXXXXXXXXXXXXXXXXXXXXXXXXXX----XXXXXXX-XXXXXXXXXXXXX-XXXXXXXXXXXXX----XXX-XXXXXXXXXXX---XXXXXXX
