------------------------------------------------------------------------------------------------------------------------------------------------------
------------------------------------------------------------------------------------------------------------------------------------------------------
------------------------------------------------------------------------------------------------------------------------------------------------------
------------------------------------------------------------------------------------------------------------------------------------------------------
------------------------------------------------------------------------------------------------------------------------------------------------------
----------------------------------------------------------------oooo------------------------------------------------ooo-------------------------------
-----------oooo-------------------------------------------------oooo------------------------------------------ooo---ooo-------ooooo-------------------
--------------------------------------------------------------------------------------------------------------ooo---ooo-------ooooo----SSSSS----------
--------------------------------------------oooo-----------------------------------------------------------------------@@@----ooooo---S---------------
-----------------------------------------g--oooo!---------------------y------------------oooooo-------------------r-------------------------!!--------
------------%%%-------------------r----tt---oooo------------------%%%%------------tt-----oooooo-----LLL--y------%%%----%%%%%----*------------------tt*
-----r---y--%%%-----------------%%%----tt%%o-----oo-------------*-%%%%------------tt-------------k-----*tt------%%%%%%%%%%%%----*--------*-%*------tt*
--y---tt----%%%--------UU-------%%%%%%%tt%%o---*-oo-------------**%%%%------------tt--------------*----*tt------%%%%%%%%%%%%----*--------**%*------tt*
M-----tt----%%%--r---y----------%%%%%%%tt%%o---*-oo-----------y-**%%%%----r---y---tt--------------*%%%%*tt--r---%%%%%%%%%%%%%%--*%%%%----**%*----y-tt*
XXXXXXXXXXXXXXX------XXXXXXXXXXXXXXXXXXXXXX----XXXXXXXXXXXXXXXXXXXXXXX----XXXXXXXXXX---XXXXXXXXXXXXXXXXXXXXXXXXXXXXXXXXXXXXXXX--XXXXXXXXXXXXXXXXXXXXXX
XXXXXXXXXXXXXXX------XXXXXXXXXXXXXXXXXXXXXX----XXXXXXXXXXXXXXXXXXXXXXX----XXXXXXXXXX---XXXXXXXXXXXXXXXXXXXXXXXXXXXXXXXXXXXXXXX--XXXXXXXXXXXXXXXXXXXXXX
