------------------------------------------------------------------------------------------------------------------------------------------------------
------------------------------------------------------------------------------------------------------------------------------------------------------
------------------------------------------------------------------------------------------------------------------------------------------------------
------------------------------------------------------------------------------------------------------------------------------------------------------
-----------------------------------------------------------------------------C------------------------------------------------------------------------
------------------------------------------------------------------------------------------------------------------------------------------------------
------------------------------------------------------------------------------------------------------------------------------------------------------
----------------------------oooo-----------------------oooo----------------------------------------------------------------@@@@----------------@@@@---
--------------------------------!!!!!ooooo------------------------------------------------------------@@@@--------------------------------------------
-------------------------------------ooooo------------------------r--------------------------r------------U----@@--------------CC---------------------
--------oooo-------tt-*-------tt--*-tt-----------------------LLLL-*----------%%%%-----------tt-------------%%%%----------------------!!!!!LLUUU----ooo
--------%------%%%%tt-*----%%%tt--*-tt-----------------%%%%oo-----*----------%%%%*----------tt---------*---%%%%--------------*---------------------tt%
--------%------%%%%tt**tt**%%%tt--*-tt%%---------------%%%%oo--%%%*------UUUU%%%%*---CCCCC--tt-------@-*tt-%%%%tt*---------*-*%%%--k-------------tttt%
M-----k-%------%%%%tt**tt**%%%tt--*%tt%%-------------k-%%%%----%%%*--k-------%%%%*----------tt----k----*tt%%%%%tt*---------*-*%%%-%%-------------tttt%
XXXXXXXXXXXX---XXXXXXXXXXXXXXXXX--XXXXXXXXXXXX----XXXXXXXXXXXXXXXXXXXXXXXXXX-XXXXX----------XXXXXXXXXX-XXXXXXXXXXXXXXXXXX--X-XXXX-XX-----XXXXXXXXXXXXX
XXXXXXXXXXXX---XXXXXXXXXXXXXXXXX--XXXXXXXXXXXX----XXXXXXXXXXXXXXXXXXXXXXXXXX-XXXXX----------XXXXXXXXXX-XXXXXXXXXXXXXXXXXX--X-XXXX-XX-----XXXXXXXXXXXXX
