------------------------------------------------------------------------------------------------------------------------------------------------------
------------------------------------------------------------------------------------------------------------------------------------------------------
------------------------------------------------------------------------------------------------------------------------------------------------------
------------------------------------------------------------------------------------------------------------------------------------------------------
----------------------------------------------------------------o-------------------------------------------------------------------------------------
-------------------------------------------------------oooooooooo------------------------------------------------------------------------------------C
-------------------------------------------------------oooooooooo--------------------------------------------------------UUU--------------------------
------------------------------------------------------------------------------------------------------------------------------------------------------
--------------------------------ooo---------------------------------------------------------------ooo-------------------------------------------------
-------------------------!!---------------------------------------k----------------------g---y--g--------------r--------------------------------------
-------------------------------------------------------*--*--%%%tt-----------------*----*-----%%%%---------tttt------------tt*------tt---------oo-----
----%%%---------------y--------------------------------*-**--%%%tt--------------*--*----*----*%%%%*----%%%%tttt*--UUo------tt*----tttt---------oo%%%%*
----%%%----------------*--------*-------------------%%-*-**--%%%tt----**--------*tt*----*----*%%%%*-%%%%%%%tttt*----o------tt*----tttt----------*%%%%*
M---%%%-%%-----k--r----*-----y--*----g--------------%%-*-**--%%%tt----**----k---*tt*----*----*%%%%*-%%%%%%%tttt*----o--k---tt*----tttt-------k--*%%%%*
XXXXXXX-XXXXXXXXXXXXXXXX---XXXXXXXXXXXXX----XXXXXXXXXX-X-XX--XXXXX----XXXXXXXXXXXXXX----X----XXXXXX-XXXXXXXXXXXX-XXX---XXXXXXX----XXXXXXXXXXXXXXXXXXXX
XXXXXXX-XXXXXXXXXXXXXXXX---XXXXXXXXXXXXX----XXXXXXXXXX-X-XX--XXXXX----XXXXXXXXXXXXXX----X----XXXXXX-XXXXXXXXXXXX-XXX---XXXXXXX----XXXXXXXXXXXXXXXXXXXX
