------------------------------------------------------------------------------------------------------------------------------------------------------
------------------------------------------------------------------------------------------------------------------------------------------------------
------------------------------------------------------------------------------------------------------------------------------------------------------
------------------------------------------------------------------------------------------------------------------------------------------------------
------------------------------------------------------------------------------------------------------------------------------------------------------
---------------------------!!!!!-------------------------------------------------------------------------------------------------!@@@@@---------------
-------------------------------------------------------------------------LLoo!!!!!----------------UUUU------------------oo----------------------------
-------------------------------------------------------ooo-----------------oo-------------------------------------------oo----------------------------
---------ooooo-----------------------------------------ooo------------------------------------------------------------------ooooo---------------------
---------------------------------------------------------------r--------------------y---------------------------------r---ooooooo-------g-------------
-------y-----------!---------%%%%---------%%%%%------------r--*-------%%%%-TT**---%%%---g-----------------------------*---oo---%%%%------%%%-----tt---
---ooo--%%%------------*-----%%%%---------%%%%%---------%%--%-*------*%%%%*TT**---%%%---%%-----------*----CCCCC-------*TT------%%%%%%%%--%%%%%%%%tt---
-k------%%%-----------***----%%%%---------%%%%%--k------%%--%-*------*%%%%*TT**---%%%*tt%%----------**----------------*TT----%%%%%%%%%%--%%%%%%%%tt---
M-------%%%-----g-----***%%%%%%%%-------r-%%%%%%%%%--g--%%%%%-*--%%-%*%%%%*TT**%%-%%%*tt%%----------**---------ooooo--*TT----%%%%%%%%%%%%%%%%%%%%tt---
XXXXXXXXXXXXXXXXXXXXXXXXXXXXXXXXX-XXXXXXXXXXXXXXXXXXXXXXXXXXX-X--XX-XXXXXXXXXXXXX-XXXXXXXXXXXXXX----XXXXXXXXXXXXXXXXXXXXXXXXXXXXXXXXXXXXXXXXXXXXXXX---
XXXXXXXXXXXXXXXXXXXXXXXXXXXXXXXXX-XXXXXXXXXXXXXXXXXXXXXXXXXXX-X--XX-XXXXXXXXXXXXX-XXXXXXXXXXXXXX----XXXXXXXXXXXXXXXXXXXXXXXXXXXXXXXXXXXXXXXXXXXXXXX---
