------------------------------------------------------------------------------------------------------------------------------------------------------
------------------------------------------------------------------------------------------------------------------------------------------------------
------------------------------------------------------------------------------------------------------------------------------------------------------
------------------------------------------------------------------------------------------------------------------------------------------------------
-----------------------------------------------------------------------------LLL----------------------------------------------------------------------
------------------------------------------------------------------------------------------------------------------------------------------------------
-----------------------------------------------------------------------------------------------------------------ooo----------------------------------
--------------------------------------------------------------------------UUU------------------------------------ooo----------------------------------
!!!---------------------------------------------------------------------------------------@@@@@------------------ooo-------@@@@@LL--------------------
---CCCCC--------------------------------------oooo!!!!!------------oo--g--------------------------------------------------------------------ooo-------
--------------tt--------%%%%------------%%----oooo-----------------oo---tt*--tt---------oo--*tt-%%%%%%-@--g-----o-----------%%%%-------tt-%%--tt---*--
--------------tt--------%%%%-------tt*--%%----oooo--------------ooooo---tt*--tt---------oo--*tt*%%%%%%---*----k----------*tt%%%%-------tt-%%--tt---*--
------%%-----%tt-------*%%%%-------tt*--%%----------tt----%%%%----------tt*tttt*--------oo--*tt*%%%%%%---*%%%----*---*---*tt%%%%TTtt---tt*%%tttt---*-*
M-----%%-----%tt---y---*%%%%-------tt*%%%%----------tt--%%%%%%----------tt*tttt*-y---y------*tt*%%%%%%---*%%%----*---*%%%*tt%%%%TTtt---tt*%%tttt---*%*
XXXXXXXXXXXXXXXXXXXXXXXXXXXXXXXXXX-XXXXXXXXXXXXXXX--XX--XXXXXXXXXXXXXXXXXXXXXXXXXXX---XXXXXXXXXXXXXXXXXXXXXXXXXXXX---XXXXXXXXXXXXXXX---XXXXXXXXXXXXXXX
XXXXXXXXXXXXXXXXXXXXXXXXXXXXXXXXXX-XXXXXXXXXXXXXXX--XX--XXXXXXXXXXXXXXXXXXXXXXXXXXX---XXXXXXXXXXXXXXXXXXXXXXXXXXXX---XXXXXXXXXXXXXXX---XXXXXXXXXXXXXXX
