------------------------------------------------------------------------------------------------------------------------------------------------------
------------------------------------------------------------------------------------------------------------------------------------------------------
------------------------------------------------------------------------------------------------------------------------------------------------------
------------------------------------------------------------------------------------------------------------------------------------------------------
------------------------------------------------------------------------------------------------------------------------------------------------------
--------------------------------------------------CCCC----------------------------------------oo------!!----------------------------------------------
-----------------------------------------------------------------------------S------------@@@@oo--------oo-----------------------C--------------------
---------------------ooo----------------------------------------------------------------------oo--------oo--------------------------------------------
---------------S-----ooo----------------------------------ooooo---------------------------------------------------------------------------------------
---g---y----------k-------------------------g-------------ooooo-----------------y--------------------------r---------oo-------------------------------
----%%%%---------tt---------------------%-tt-----------------------------oooott--*-----%%----tt--------tt-*----------oo---------*--------------------o
----%%%%------o--tttt--%%%%ttoooo-tt----%*tt---ooo-tt--------------------oooott***U--tt%%----tt--------tt-*------@@@@oo---------*-ooo-----------y-oooo
----%%%%----UUo*-tttt%%%%%%tt-----tt----%*tt--@ooo-tt-----------------!!!----tt***---tt%%----tt--------tt**---------------------*tt------------tt----o
M---%%%%--k----*%tttt%%%%%%tt-----tt----%*tt-------tt---%%%---------------%%%tt***%%%tt%%----tt--------tt**----r--------g-------*tt---------%%%tt-----
XXXXXXXXXXXXXXXXXXXXXXXXXXXXXXXXXXXX----XXXXXXXXXXXXXXXXXXXXXXXXXXXXXXXXXXXXXXXXXXXXXXXXX----XXXXXXXXXXXXXX-XXXXXXXXXXXXXXXXXXXXXXX---XXXXXXXXXXXXXXXX
XXXXXXXXXXXXXXXXXXXXXXXXXXXXXXXXXXXX----XXXXXXXXXXXXXXXXXXXXXXXXXXXXXXXXXXXXXXXXXXXXXXXXX----XXXXXXXXXXXXXX-XXXXXXXXXXXXXXXXXXXXXXX---XXXXXXXXXXXXXXXX
