------------------------------------------------------------------------------------------------------------------------------------------------------
------------------------------------------------------------------------------------------------------------------------------------------------------
------------------------------------------------------------------------------------------------------------------------------------------------------
------------------------------------------------------------------------------------------------------------------------------------------------------
------------------------------------------------------------------------------------------------------------------------------------------------------
-------------------------UUUU-----------------------!!!!!-------------------------------------------------------------LLL------------UUUU-------------
-----------------------------------------SSS----------------------------------------------------------------------------------------------------------
--------------------------------------------oo--------------------------UU---------------------------------------------------o------------------------
--------------------------------------------oo---------------------UUU---------------------------------------------------@@@-o------------------------
--------------------------------------------oo--------------------y----------------------------------------------------------o------------------------
--------------o----------tt*--------CCCCC---*---------*-----------tt--oo----------------C-----tt----------------------------y-------------------------
-----------*------tt-----tt*----------------*---------*-----------tt------ooooo-tt------------tt--------tt---------%-k*%%%%TT-%%%%--*tt------tt----CCC
---oo------*------tt-----tt*--CCCCC-----%%%%*-k----o--*-------tt--tt----ttooooo-tt---*-L------tt--------tt*--------%%%*%%%%TT*%%%%tt*tt%%----tttt-----
M--oo------*------tt----rtt*-g-----r----%%%%*%%%------*--ro---tt--tt----ttooooo-tt---*--------tt--g---r-tt*-kk-----%%%*%%%%TT*%%%%tt*tt%%----tttt%%%%-
XXXXXXXXXXXXXXXXXXXXXXXXXXXX----XXXXXXXXXXXXXXXXXXXXXXXXXXXXXXXX--XXXXXXXXXXXXXXXXXXXX--------XXXXXX----XXXXXXXXXXXXXXXXXXXXXXXXXXXXXXXXX----XXXXXXXX-
XXXXXXXXXXXXXXXXXXXXXXXXXXXX----XXXXXXXXXXXXXXXXXXXXXXXXXXXXXXXX--XXXXXXXXXXXXXXXXXXXX--------XXXXXX----XXXXXXXXXXXXXXXXXXXXXXXXXXXXXXXXX----XXXXXXXX-
