------------------------------------------------------------------------------------------------------------------------------------------------------
------------------------------------------------------------------------------------------------------------------------------------------------------
------------------------------------------------------------------------------------------------------------------------------------------------------
------------------------------------------------------------------------------------------------------------------------------------------------------
------------------------------------------------------------------------------------------------------------------------------------------------------
---------CC------------------------------------------------------------------------------------------------------------------C------------------------
------------------------ooo---UUUUU-UUUU--------------------------------------------------------------------------------------------------------------
------------------------ooo---------------------------------------------------------------------------------------------------------------------------
--------------SSSS---------ooo---------------------------------------------------------------------------------------S--------------------------------
------------r--------------ooo-----S--------------------------------------k---k--------------------------------------------y--CCCCooo--------UU-------
-----*----tt------------tt---tt-%%%------------g----g-o---tt-*tt------r-tt----tt---------oo-----------------tt%%%--tt---r-*-------ooo-----------------
-----*--tttt------------tt---tt*%%%%%%----------tt%%%%o---tt-*tt------%%tttt--tt---------oo-----------------tt%%%--tt--*--*tt*tt----------------------
--g--*--tttt---TT-SSLLLLtt---tt*%%%%%%tttt------tt%%%%o--*tt-*tt%%----%%tttt--tt-----------------------*@@@@tt%%%tttt***tt*tt*tt*----SSSSS-----------U
M---%*--tttt---TT-------tt---tt*%%%%%%tttt------tt%%%%%--*tt-*tt%%----%%tttt--tt------k----------------*----tt%%%tttt***tt*tt*tt*----------g----------
XXXXXX--XXXXXXXXXXXXXXXXXX---XXXXXXXXXXXXXXXXXXXXXXXXXX--XXX-XXXXXXXXXXXXXXX--XX---XXXXXXXX-------XXXXXX----XXXXXXXXXXXXXXXXXXXXXXXXXXXXXXXXXXXXXXXXXX
XXXXXX--XXXXXXXXXXXXXXXXXX---XXXXXXXXXXXXXXXXXXXXXXXXXX--XXX-XXXXXXXXXXXXXXX--XX---XXXXXXXX-------XXXXXX----XXXXXXXXXXXXXXXXXXXXXXXXXXXXXXXXXXXXXXXXXX
