------------------------------------------------------------------------------------------------------------------------------------------------------
------------------------------------------------------------------------------------------------------------------------------------------------------
------------------------------------------------------------------------------------------------------------------------------------------------------
------------------------------------------------------------------------------------------------------------------------------------------------------
------------------------------------------------------------------------------------------------------------------------------------------------------
------------------------------------------------------------------------------------------------------------------------------------------------------
---------------------@@@@----o--------------------------------------------------------------------------------------------------------------L---------
-----------------------------o------------------------------------------------------------------------------------------------------------------------
-----------------------------o--------------LL-----oooo------------------------oo-----------SSS------------ooooo-----------------------oooo----------C
----------oooo----------------------------r--------oooo---------------------k--oo------------------------oo-----oooo------------k------oooo-----------
!!!-----k---%%%%---*---------*-----oooo--tt---!!!!!oooo----*-----------------%%oo----------------------!!oo-----oooo--------------%%---tt--o----------
---------%%%%%%%---*---------*--k------o-tt----------------*--------TT-------%%tt-oo--y------------------oo------%%%--------------%%---tt--o%TT-----**
--------*%%%%%%%---*tt-------*-*----**-o-tt--------*%%*----*--------TTo------%%tt-oo**-----------------------tttt%%%-------g------%%---tt--o%TT-----**
M----k--*%%%%%%%---*tt------%*-*----**-o-tt--------*%%*--k-*--------TT--r----%%tt-oo**----k------y---k-------tttt%%%--k-----%-----%%---tt%%%%TT-----**
XXXXXXXXXXXXXXXX---XXXXXXXXXXX-XXXXXXX---XXXXXXXXXXXXXX----X--------XXXXXXXXXXXXXXXXXXXXXXXXXXXXX---XXXXX----XXXXXXXXXXXXXXXX-----XX---XXXXXXXXXXXXXXX
XXXXXXXXXXXXXXXX---XXXXXXXXXXX-XXXXXXX---XXXXXXXXXXXXXX----X--------XXXXXXXXXXXXXXXXXXXXXXXXXXXXX---XXXXX----XXXXXXXXXXXXXXXX-----XX---XXXXXXXXXXXXXXX
