------------------------------------------------------------------------------------------------------------------------------------------------------
------------------------------------------------------------------------------------------------------------------------------------------------------
------------------------------------------------------------------------------------------------------------------------------------------------------
------------------------------------------------------------------------------------------------------------------------------------------------------
-------------------------------------------------------------------------------------------------LL---------------------------------------------------
----------------------------------------------------------------------------------------------------------------------------------------------------o-
---------------------------------oo-----------------------------------------------o--------------------UU------------------------o------------------o-
@@@---------------------------!!!oo-----------------------------------------------o----------------------------------------------o--------------------
------SSSS-------------oo--------oo---------------SSSS----------------------------------------------ooo---------------o----------o----------!!!!!-----
----------oooo-------------------------------------------------------------------C------------------ooo------------r--o-------------------------------
--------------------k--------L--------------------------k-oo-r-------tt*-------r--*------tt---%%%%-----*--k----------%----------------------------y-%t
----------%%%%-------%%%%------*---------------------%%%%-tttt---y-tttt*--------tt*--k---tt---%%%%-S---*TT--UULLL----%-------------------------%%%%-%t
---!!!----%%%%------*%%%%------*tt------------------*%%%%-tttt----*tttt*ooooo---tt*----tttt---%%%%--%%%*TT-*---------%%-*--------%%%-tt--------%%%%-%t
M---------%%%%--g---*%%%%-y----*tt-------%---%%%----*%%%%-tttt----*tttt*ooooo---tt*----tttt%%%%%%%--%%%*TT-*---------%%-*---ooooo%%%-tt--------%%%%-%t
XXXXXXXXXXXXXX--XXXXXXXXX------XXX-------X---XXX----XXXXX-XXXX----XXXXXXXXXXX---XXX----XXXXXXXXXXX--XXXXXX-X----XXXXXXX-XXXXXXXXXXXX-XXXXXXXXXXXXXX-XX
XXXXXXXXXXXXXX--XXXXXXXXX------XXX-------X---XXX----XXXXX-XXXX----XXXXXXXXXXX---XXX----XXXXXXXXXXX--XXXXXX-X----XXXXXXX-XXXXXXXXXXXX-XXXXXXXXXXXXXX-XX
