------------------------------------------------------------------------------------------------------------------------------------------------------
------------------------------------------------------------------------------------------------------------------------------------------------------
------------------------------------------------------------------------------------------------------------------------------------------------------
------------------------------------------------------------------------------------------------------------------------------------------------------
------------------------------------------------------------------------------------------------------------------------------------------------------
------------------------------------------SSS@@@-----------------------------------------------------------------------------------------CCCCC--------
-----------------ooo----------------------------------------------------------LLLL----------------ooo----------------------------------------------ooo
-----------------ooo------------------------------------------------------------------------------ooo-----------------------------------S----------ooo
------------------------------------------------oooooooooo----------------oooo--------------------ooo-------------------------------------------------
----------------------------------------y-------oooooooooo----------------oooo------------------------------------------------------------------------
------------------TT-----*---------SS----*-**-------*oooo---------oo------------------------------tt------------*-------------------------------r--tt-
---------------oo-TT-----*tt--*-------tt-****--*----*---tt------------!-g---*---------------------tt------%%%---*------oo-----SS--------%%%----%%%%tt-
--g--------tt---ttTT-----*tttt*-------tt*****--*----*---tt-------U--oo--tttt*%%%--oooo------------tt------%%%tt%**----------------------%%%----%%%%tt%
M-----k--y-tt---ttTT%%---*tttt*---%%%%tt*****--*--%%*---tt--k--y--------tttt*%%%--oooo------------tt------%%%tt%**---g------------g-----%%%%%%%%%%%tt%
XXXXXXXXXXXXX---XXXXXX---XXXXXX---XXXXXXXXXXX--X--XXX---XX------XXXXXXXXXXXXXXXXXXXXXXXXXXXXXXXXXXXX-XXXXXXXXXXXXX--XXXXXXX---XXXXXXXXXXXXXXXXXXXXXXXX
XXXXXXXXXXXXX---XXXXXX---XXXXXX---XXXXXXXXXXX--X--XXX---XX------XXXXXXXXXXXXXXXXXXXXXXXXXXXXXXXXXXXX-XXXXXXXXXXXXX--XXXXXXX---XXXXXXXXXXXXXXXXXXXXXXXX
