------------------------------------------------------------------------------------------------------------------------------------------------------
------------------------------------------------------------------------------------------------------------------------------------------------------
------------------------------------------------------------------------------------------------------------------------------------------------------
------------------------------------------------------------------------------------------------------------------------------------------------------
----------------!!!!--------------------CCCCC---------------------------------------------------------------------------------------------------------
----------------------------------------------------------------------------------------------------------------------------------------ooo-----------
-----------SSSSS-------------------------------oooLL-----------LLL-------------SSSSS----------------------------@@@@--------------------ooo------oo---
--------------------------UUU--------------------------------------------------------------------------------------------------------------------oo---
------SSSSS---------LLLL------------------------------------CLL-----------------------oo---CC-----CCCCC-----------------------------------------------
----------------------------------------------r-------------------------------------o-oo-------!!!----------------------------------------------g-----
------------------tt-----------------------%-gtt---*---UUUUU-------------------tt---o-oo-----------tt-----------tt-----*-----------------*-ooooott----
------*-------%%%%tt-----------------------%tttt---*-----------*--------------*tt------------or----tt----!!-ooo-tt-----*-----------------*-ooooott----
------*-%%%%tt%%%%tt---------oooooooooo----%tttttt-*%%%--------*------%%------*tt------*g----o*----tttto--------tt-----*-----------------*TT----tt----
M-----*-%%%%tt%%%%tt----gy%--ooooo-----k---%tttttt-*%%%----%%%-*------%%---k--*tt------*%%%---*----ttttok--r---gtt-----*----gyy--------g-*TT----tt----
XXXXXXX-XXXXXXXXXXXX---XXXXXXXXXX---XXXXXXXXXXXXXX-XXXXXXXXXXX-X------XXXXXXXXXXXXXXXXXXXXX---X----XXXX---XXXXXXXXXXXXXX--XXXXXXXXXXXXXXXXXX----XX----
XXXXXXX-XXXXXXXXXXXX---XXXXXXXXXX---XXXXXXXXXXXXXX-XXXXXXXXXXX-X------XXXXXXXXXXXXXXXXXXXXX---X----XXXX---XXXXXXXXXXXXXX--XXXXXXXXXXXXXXXXXX----XX----
