------------------------------------------------------------------------------------------------------------------------------------------------------
------------------------------------------------------------------------------------------------------------------------------------------------------
------------------------------------------------------------------------------------------------------------------------------------------------------
------------------------------------------------------------------------------------------------------------------------------------------------------
------------------------------------------------------------------------------------------------------------------------------------------------------
----------------------------------------------------------!!!-------------------------------------------------------------------LL--------------------
------------------------------------------------------------------------------------------ooo---------------------------------------------------------
-----------------UU--------------------------------------------------------CCCCCUU------------------@-------------------------------------------------
-------------------------------------------------------------------------UU-------oooo----------!!!!-!----------------------------ooooo---------------
-------------------------------------------------------------oooo----------------------------Loo-----------UU---------------------------ooo-----------
----------tt-**-%%%@@@@@-------ooo-----------*-------%%%%----oooo-%%%%-----tt----------*-%%%%-oo-tt----------oo---------k---------tt--*Sooo------oU---
----------tt-**-%%%----------------------*---*-------%%%%---*tt---%%%%*----tt--------tt*-%%%%-oo-tt---LLLL---oo--*----@@%%-*tttt%%tt--*-ooog-------UUU
--------**tt-**-%%%tt-------------U------*---*tt-----%%%%---*tt---%%%%*----tt--------tt**%%%%%%%%tttt%-----------*------%%**tttt%%ttTT*----*!!!!------
M-------**tt%**-%%%tt---oo---------k-----*---*tt-----%%%%---*tt---%%%%*----tt---%%%%%tt**%%%%%%%%tttt%----y------*------%%**tttt%%ttTT*----*----r-----
XXXXXXX-XXXXXXX-XXXXXXXXXXXXXXXXX--XXXXXXXXXXXXXXXXXXXXXXXXXXXX---XXXXX----XXXXXXXXXXXXXXXXXXXXXXXXXXX-------XXXXXXXXXXXXXXXXXXXXXXXXXX----XXXXXX-----
XXXXXXX-XXXXXXX-XXXXXXXXXXXXXXXXX--XXXXXXXXXXXXXXXXXXXXXXXXXXXX---XXXXX----XXXXXXXXXXXXXXXXXXXXXXXXXXX-------XXXXXXXXXXXXXXXXXXXXXXXXXX----XXXXXX-----
