------------------------------------------------------------------------------------------------------------------------------------------------------
------------------------------------------------------------------------------------------------------------------------------------------------------
------------------------------------------------------------------------------------------------------------------------------------------------------
------------------------------------------------------------------------------------------------------------------------------------------------------
-------------------------------------------------------!!!--------------------------------------------------------------------------------------------
-----------------------------------------------------oo---!-------------------------------------------------------------------------------------------
---------------------------------------------------CCoo------------oooo---------------------------oLL-------------------------------------------------
-----------------------------------------------------oo-----ooooo--oooo-------------------------o-o---------------------------------------------------
-----------oo---------------------ooo----------CCCC---------ooooo----------------------oooooooooo-o--------@@@@@@--U------------------------------oooo
-----------ooo--------------------ooo-----------------------ooooo--------------------------ooooo-k-------CC-------------------y-----UUU-----------oooo
-----tt----ooooo------------%%%%--ooo-!!!!-oooo---tt*----*-o*---------*------------------------%%%----------*---------------**%ooooo---%%%-*--oo--%%%%
-----tt-------ooCCCC--------%%%%-----------oooo--*tt*%%--**o*----oo---*---------------y----TT--%%%*tt-------*-----g-k---!!!!**%oo------%%%-*%%----%%%%
-----ttUUUU---oo------------%%%%----------------%*tt*%%tt**-*----oo---*------------%%%%%%%%TT-*%%%*ttCCCC---*-----tt*ooo----**%oo------%%%-*%%----%%%%
M----tt-----------------y---%%%%----------g-----%*tt*%%tt**-*----oo---*--k---------%%%%%%%%TT-*%%%*tt-------*%%%-ktt*-------**%----%%%%%%%-*%%----%%%%
XXXXXXX--XXXXXXXXXXXXXXXXXXXXXXX----XXXXXXXXXXXXXXXXXXXXXXX-XXXXXXX---X----XXXXXXXXXXXXXXXXXX-XXXXXXX-XXXXXXXXXX--XXXXXXXXXXXXX----XXXXXXX-XXX----XXXX
XXXXXXX--XXXXXXXXXXXXXXXXXXXXXXX----XXXXXXXXXXXXXXXXXXXXXXX-XXXXXXX---X----XXXXXXXXXXXXXXXXXX-XXXXXXX-XXXXXXXXXX--XXXXXXXXXXXXX----XXXXXXX-XXX----XXXX
