------------------------------------------------------------------------------------------------------------------------------------------------------
------------------------------------------------------------------------------------------------------------------------------------------------------
------------------------------------------------------------------------------------------------------------------------------------------------------
------------------------------------------------------------------------------------------------------------------------------------------------------
------------------------------------------------------------------------------------------------------------------------------------------------------
-----------------------------------------------------------------------------------------------------------SSS----------------------------------------
-----------------------CCCCC--------------------------------------------------------------------------------------------------------------------------
-----------------------------------------------------------------LLLLL-----------------------ooooo----ooo----------------oooo-------------------------
SSSS-------------------------oo---------------------ooo--------------------------------------ooooo----ooo----------ooo---oooo-------------------------
-----------------------------oo---------------------ooo-----------------------o--------------ooooo-------oo-----g--ooo--------------------------ooooo-
-----o------------*----*--%%%%-o-----------*------tt------tt--------tt*-------o-------*tt-----------------------*---------------------%---**----ooooo-
----*-!----oooooo-*----*-*%%%%--LLL--------*------tt-*----tt--------tt*-------o-------*tt------------------*----*%%---ooo%%-----------%---**--k-ooooo-
----*-------------*----***%%%%-------------*%%%---tt%*%%%%tt--------tt**--------------*tt----*-------%%%%%%*----*%%tt%%%%%%-----------%---**-%%%%-----
M---*----r--------*----***%%%%%%%%-%%%%----*%%%---tt%*%%%%tt--------tt**%%------------*tt----*-------%%%%%%*----*%%tt%%%%%%-----------%---**%%%%%----y
XXXXX--XXXXXXXXXXXXXXXXXXXXXXXXXXX-XXXX----XXXXXXXXXXXXXXXXXXXXXXXXXXXXXXXXXXXXXXXXXXXXXXXXXXX---XXXXXXXXXXXXXXXXXXXXXXXXXXXXXXXXX----XXXXXXXXXXX-----
XXXXX--XXXXXXXXXXXXXXXXXXXXXXXXXXX-XXXX----XXXXXXXXXXXXXXXXXXXXXXXXXXXXXXXXXXXXXXXXXXXXXXXXXXX---XXXXXXXXXXXXXXXXXXXXXXXXXXXXXXXXX----XXXXXXXXXXX-----
