------------------------------------------------------------------------------------------------------------------------------------------------------
------------------------------------------------------------------------------------------------------------------------------------------------------
------------------------------------------------------------------------------------------------------------------------------------------------------
------------------------------------------------------------------------------------------------------------------------------------------------------
------------------------------------------------------------------------------------------------------------------------------------------------------
-------------------------------------------------------------------------------------------------------------------------------------------------CCC--
-----------------------------------------------------------------------------------------------------------CC-----------------------------------------
-----------------------------!!!!---------------------------------------------------------------------------------------------------------------------
------------------------------------SSS---------------------------------------------U-------------------------------------------------------!!!!!-----
-------------------------oooo-----------------------------------------------------oo-------------------------ooo-------------C------S-----------------
------------TT**%--------oooo-*--------!!!!-----*--------------------*-tt-r-------oo-----------%------*----%%ooo------------------------------%%%*----
S-----------TT**%---k-ooo-----*-----------------*--------%%----------*-tt-tt------oo-----------%------*oooo%%*tt----------------oooo----TT%%%%%%%*--oo
---tt-------TT**%tt---ooo-----**----------------*--------%%--------tt**tt*tt%%%---------------*%------*oooo%%*tt----------------oooo----TT%%%%%%%*%%%%
M--tt-------TT**%tt---ooo-----**--r-------------*--------%%--------tt**tt*tt%%%--------r------*%------*----%%*tt---k------------------k-TT%%%%%%%*%%%%
XXXXX-XXX---XXXXXXXXXXXX-XXX--XX--XXXXXXXXXXXXXXXXXXXXXXXXXXXXXXXXXXXXXXXXXXXXXXXXXXXXXXXXXXXXXXXXXXXXXXXXXXXXXXXXXXXXXXXXXXXXXXXXXXX---XXXXXXXXXXXXXX
XXXXX-XXX---XXXXXXXXXXXX-XXX--XX--XXXXXXXXXXXXXXXXXXXXXXXXXXXXXXXXXXXXXXXXXXXXXXXXXXXXXXXXXXXXXXXXXXXXXXXXXXXXXXXXXXXXXXXXXXXXXXXXXXX---XXXXXXXXXXXXXX
