------------------------------------------------------------------------------------------------------------------------------------------------------
------------------------------------------------------------------------------------------------------------------------------------------------------
------------------------------------------------------------------------------------------------------------------------------------------------------
------------------------------------------------------------------------------------------------------------------------------------------------------
------------------------------------------------------------------------------------------------------------------------------------------------------
-------------------------------------------------------oooo-------------ooooo--------------!!!!!------------------------------------------------------
-------------------------------------------------------oooo-------------ooooo----------@@@@-----------------------------------------------------------
---------oooo---------------------------------------------------------oo------------------------------------------------------------------------------
---------ooooLLL----UU---------o--------------------------------------oo------------------------@@@@----------o--@@@-----------CCCC-------------------
---------oooo-----k------------o---------oo---------------------------oo--------SSSSSoo--------------------------------------------@@@@---------------
-------------%%%-TT-----g-o----o-----@@@@--*-----------*------------y---%%---CCC-----tt-------*---------------------------------*---------------------
-------------%%%-TT*%%%%-----g----r------tt**tt--------*-----------%%%tt%%-----------tt*------**---------------tt---------------*--------------r------
--y------*---%%%*TT*%%%%*---tt-----tt----tt**tt--------*------!!oo%%%%tt%%tt---------tt*------**-----------tt**tt--------------%*-----------o---tt---C
M-----y--*---%%%*TT*%%%%*---tt-----tt----tt**ttooo--y--*----g-----%%%%tt%%tt---------tt*------**------k----tt**tt--------------%*--------k--o---tt----
XXXXXXX--XXXXXXXXXXXXXXXXXXXXXXXXXXXXXXXXXXXXXXXXXXXXXXX----XXXXXXXXXXXXXXXXXXXXXXX--XXXXXX---XXXXXXXXXXXXXXXXXXXXXXXXXXXXXXXXXXXXXXX-XXXXXXXXXXXXXXXX
XXXXXXX--XXXXXXXXXXXXXXXXXXXXXXXXXXXXXXXXXXXXXXXXXXXXXXX----XXXXXXXXXXXXXXXXXXXXXXX--XXXXXX---XXXXXXXXXXXXXXXXXXXXXXXXXXXXXXXXXXXXXXX-XXXXXXXXXXXXXXXX
