------------------------------------------------------------------------------------------------------------------------------------------------------
------------------------------------------------------------------------------------------------------------------------------------------------------
------------------------------------------------------------------------------------------------------------------------------------------------------
------------------------------------------------------------------------------------------------------------------------------------------------------
------------------------------------------------------------------------------------------------------------------------------------------------------
----------------------------------------------------------------------------------------------------------------------------------------------SSSS----
--------------------------------------------------------------------------------------------------------------------------------------!!--------------
@------------------------------------------------!!!!!------------------------------------------------------------------------------------------------
--------------!!----ooo--CC---------------------------------LLLLSSSSSSSS------------------------------------------------------------------------------
-----------k--------oooLL-----------------------------------------------------------------------r--oooo---------------------------g-----------------r-
---------%%%%%%---y-----------------------------------------------------------------------!!!!--*--oooo--oooCCC------------------%%%%---------*-----tt
---------%%%%%%**-%%%%---------------------------------k-------*----------tt-----o-tt--ooo------*--oooo--ooo-------ooo-----r--g--%%%%-tt------*-----tt
---------%%%%%%**-%%%%-------------------------------%%%%------*-------tt*tt-------tt*-ooo---*--*------SS----------ooo-----*TT---%%%%%ttTT----*----*tt
M--------%%%%%%**-%%%%-------------------------------%%%%------*-------tt*tt-------tt*-------*--*----------------k---------*TT---%%%%%ttTT%%%%*----*tt
XXXXX----XXXXXXXX-XXXXXXXX---XXXXXXXXXX----XXXXXXXX--XXXXXXXXXXXXXXXXXXXXXXXXXXXXXXXXXXXXXXXXX--X-XXXXXXXXXXXXXXXXXXXXXXXXXXXXXXXXXXXXXXXXXXXXX----XXX
XXXXX----XXXXXXXX-XXXXXXXX---XXXXXXXXXX----XXXXXXXX--XXXXXXXXXXXXXXXXXXXXXXXXXXXXXXXXXXXXXXXXX--X-XXXXXXXXXXXXXXXXXXXXXXXXXXXXXXXXXXXXXXXXXXXXX----XXX
