------------------------------------------------------------------------------------------------------------------------------------------------------
------------------------------------------------------------------------------------------------------------------------------------------------------
------------------------------------------------------------------------------------------------------------------------------------------------------
------------------------------------------------------------------------------------------------------------------------------------------------------
------------------------------------------------------------------------------------------------------------------------------------------------------
----------------------------------------------!!!!-------------------------------!!!!!----------------------------------------------------------------
------------------------------------------------------------------------UUU----------------!!!!!!!!!--------------------------------------------------
---------------------------------------------------------------------!!!--------------------------------------------------o-----------------------ooo-
----------ooooo-----------------------------------------------------------------------------------------------------------o-------@@@@@---------------
-----o--------------------------------------------------------------------------------o-----------------------------------o---------------------------
---ooo--g-------------------------tt-----------*-------tt--tt**-------*%%tt--tt------*o-------------------------------oooott------*-------tt---%%%--*-
---oo----tt------%%%%-%%----------tt----g---r--*----%tttt--tt**---tttt*%%tt--tt----%**-------------------------y----------tttt%---*-------tt---%%%--*-
---------tt%%---%%%%%*%%----------tt----%---*--*%%%%%ttttTTtt**--*tttt*%%tt--tt----%**--------*%%---tt---ttCC--tto-----%%%tttt%---*-------tt---%%%--*-
M--------tt%%---%%%%%*%%----------tt----%---*--*%%%%%ttttTTtt**--*tttt*%%tt--tt----%**--------*%%---tt---tt--%%tto--k--%%%tttt%---*-----y-tt---%%%--*y
XXXXXXXXXXXXX---XXXXXXXX----XXXXXXXX----X---X--XXXXXXXXXXXXXXXX--XXXXXXXXXX--XX----XXX--------XXX---XX---XX--XXXXXXXXX-XXXXXXXX---XXXXX---XXXXXXXX--X-
XXXXXXXXXXXXX---XXXXXXXX----XXXXXXXX----X---X--XXXXXXXXXXXXXXXX--XXXXXXXXXX--XX----XXX--------XXX---XX---XX--XXXXXXXXX-XXXXXXXX---XXXXX---XXXXXXXX--X-
