------------------------------------------------------------------------------------------------------------------------------------------------------
------------------------------------------------------------------------------------------------------------------------------------------------------
------------------------------------------------------------------------------------------------------------------------------------------------------
------------------------------------------------------------------------------------------------------------------------------------------------------
------------------------------------------------------------------------------------------------------------------------------------------------------
------------------------------------------------------------------------------------------------------------------------------------------------------
------------L-----------------------------------------------------------------------------------------------------------------------------------------
-------------------------------------------------------------------------------------LLLLL-------------------------------------------------------oo---
-------!!!!----------------------------------------------------------------------------------------------------------------------------------oooooo---
-----C-----@-------LL----U--------------------------------------------g------------k--------------------------ooooo---k----------------------oooooo-k-
-----------------------y--ooo--o--------------tt----------tt--------%%%%-----ooooo-%---*-------------------------------tt-----------------------*---tt
------o---%tto---------tt-oooLLo---------o%%%%tt----------tt-*------%%%%-----ooooo-%-tt*---tt%%-------------------%%%--tt-----------------------**--tt
--g-------%tto---------tt-ooo--o--------So%%%%tt-------tt*tt-*----tt%%%%-----ooooo-%-tt*%%%tt%%-------------------%%%tttt%%%%---------%%%%------**%%tt
M---------%tt---r------tt--%%%%---y---y--o%%%%tt-------tt*tt-*----tt%%%%--k--------%%tt*%%%tt%%----r--------------%%%tttt%%%%---------%%%%------**%%tt
XXXXXXXXXXXXXXXXXXXX---XX--XXXXXXXXXXXXXXXXXXXXXXXXXXXXXXXXX-XXXXXXXXXXX---XXXXXXXXXXXXXXXXXXXX-XXXXXXXX----XXXXXXXXXXXXXXXXX------XXXXXXXXXXXX-XXXXXX
XXXXXXXXXXXXXXXXXXXX---XX--XXXXXXXXXXXXXXXXXXXXXXXXXXXXXXXXX-XXXXXXXXXXX---XXXXXXXXXXXXXXXXXXXX-XXXXXXXX----XXXXXXXXXXXXXXXXX------XXXXXXXXXXXX-XXXXXX
