------------------------------------------------------------------------------------------------------------------------------------------------------
------------------------------------------------------------------------------------------------------------------------------------------------------
------------------------------------------------------------------------------------------------------------------------------------------------------
------------------------------------------------------------------------------------------------------------------------------------------------------
------------------------------------------------------------------------------------------------------------------------------------------------------
------------------------------------------------------------------------------------------------------------------------------------------------------
------------------------------------------------------------------------------------------------------------------------------------------------------
-------------------------------------------CCC-------------------------------------------------------------ooooo----------@@@-------------------------
-----UU---------------------------!!!!-----------------UUUU----------------------------------------------SS-------------------------------------------
----------------------------------------------------------------------CCCC------------------------------------------------------------r----k----------
---------------*tt------------------*---g-------g-----------------------------------------g----r-------oott---ttooo------------------%%%--*-----------
--------tt---tt*tt------------------**--%tt---tt-----g------------------------%%%-----CC----%%-------LLoott%%%ttooo------*-----------%%%--*----------r
--------tttt*tt*tt--------oooo-tt---**--%tt-*-tt*-@@--*--------tt-------------%%%--k--------%%---------oott%%%tt---oo----*tt*------tt%%%tt*---------%%
M-------tttt*tt*tt-------------tt---**--%tt-*-tt*-----*--------tt%%%----------%%%----%%%----%%-----r-----tt%%%tt---%%----*tt*------tt%%%tt*-------y-%%
XXXXXXXXXXXXXXXXXXXXXXXXXXXXXXXXXXXXXX--XXX-X-XXXXXXXXXXXXXXXXXXXXXX---XXXXXXXXXX----XXXXXXXXX-XXXXXXXXXXXXXXXXXXXXXX----XXXXXXXXXXXXXXXXXXXXXXXXXXXXX
XXXXXXXXXXXXXXXXXXXXXXXXXXXXXXXXXXXXXX--XXX-X-XXXXXXXXXXXXXXXXXXXXXX---XXXXXXXXXX----XXXXXXXXX-XXXXXXXXXXXXXXXXXXXXXX----XXXXXXXXXXXXXXXXXXXXXXXXXXXXX
