------------------------------------------------------------------------------------------------------------------------------------------------------
------------------------------------------------------------------------------------------------------------------------------------------------------
------------------------------------------------------------------------------------------------------------------------------------------------------
------------------------------------------------------------------------------------------------------------------------------------------------------
------------------------------------------------------------------UUUUU--------------------------------------------------SS---------------------------
------------------------------------------------------------------------------------------------------------------------------------------------------
------------------------------------------------------------------------------------------------------------------------------------------------------
-----------------SSSSS------LL------------------------------------------------LLL---------------------------------------------------------------------
-------------------------SS-----LLLLL-----------------------------------------------------------------------------oooo--------------------oooo--------
----CLLLL---------------------oo------------------------------------------------------oooo----------------------------ooo----------oo-----oooo-!------
--------------------tt-oo-----oo---tt----UU-------------------*%%%%----UU----**ttooooooooo------------------------------tt-----------CCCC-oooo--------
--------------------tt-oo----------tt------oooo---------------*%%%%----------**tt---ttoooo-------tt*@@@@@-@@@@----------tt-------%%%*------*----------
--------*-----tt----ttC-----*------tt--------*----------------*%%%%----------**tt---tt--------%%%tt*-----y----oooo--%%tttt-------%%%*------*----------
M-------*-----tt----tt------*------tt--------*----------------*%%%%------y---**tt%%%tt--------%%%tt*----%%%---------%%tttt-------%%%*----o-*--k-y-----
XXXXXXXXXXXXXXXX----XXXXXXXXXXXXXXXXX-XXXXXXXX-----------XXXXXXXXXX---XXXXXXXXXXXXXXXXXXXXXXXXXXXXXX----XXXXXXXXXXXXXXXXXXXXXXXXXXXXX---XXXXXXXXXX----
XXXXXXXXXXXXXXXX----XXXXXXXXXXXXXXXXX-XXXXXXXX-----------XXXXXXXXXX---XXXXXXXXXXXXXXXXXXXXXXXXXXXXXX----XXXXXXXXXXXXXXXXXXXXXXXXXXXXX---XXXXXXXXXX----
