------------------------------------------------------------------------------------------------------------------------------------------------------
------------------------------------------------------------------------------------------------------------------------------------------------------
------------------------------------------------------------------------------------------------------------------------------------------------------
------------------------------------------------------------------------------------------------------------------------------------------------------
----------------------------------LLLL--------------------------------------------------------------------------------------------------CC------------
---------------------UU------------------------------------------------------------------------------------------------------------ooooo--------------
-----UUUU--------------!-----------------------------------------------------------------------------------------------SSSS--------ooooo----------!!!!
-----------------------------------------------------------------------------------------------------------------------------------ooooo--------------
-----------------------------------------------------------UUUUULLL-----------------------------------o-----------------------------------------------
-----------k---------------------------g-------------------------------------r--------g-------------k-o-----------y-----------------------------------
-----%%%---tt--------------------U---TT------------------------------------tt--*---TT---------------tto-----------*----------------*tt-%%------@@@%%%%
-----%%%---tt--------tt--------------TT--@@@-*-----------------%%*-------y-tt--*---TT-----k--ooooo--tt-------*----*----*-----------*tt-%%---------%%%%
--k--%%%-@-tt------oott*----*%%%%%%%*TT------*----------------*%%*---%%%%--tt--*---TT----TT---------tt---%%%%*----*----*---tt------*tt-%%--------*%%%%
M----%%%---tt------oott*----*%%%%%%%*TT------*----%%%---g-----*%%*---%%%%%%tt--*---TT----TT-%%%%----tt---%%%%*----*-ooo*---tt------*tt-%%--------*%%%%
XXXXXXXXXXXXXXXXXXXXXXXX----XXXXXXXXXXXXXXXXXX----XXXXXXXXXXXXXXXXXXXXXXXXXXX--XXXXXXXXXXXX-XXXX----XX---XXXXX----X----XXXXXXXXXXXXXXX-XXXXXXXXXXXXXXX
XXXXXXXXXXXXXXXXXXXXXXXX----XXXXXXXXXXXXXXXXXX----XXXXXXXXXXXXXXXXXXXXXXXXXXX--XXXXXXXXXXXX-XXXX----XX---XXXXX----X----XXXXXXXXXXXXXXX-XXXXXXXXXXXXXXX
