------------------------------------------------------------------------------------------------------------------------------------------------------
------------------------------------------------------------------------------------------------------------------------------------------------------
------------------------------------------------------------------------------------------------------------------------------------------------------
------------------------------------------------------------------------------------------------------------------------------------------------------
----------------ooo-----------------------------------------------------------------------------------------------------------------------------------
----------------ooo-----------------------------------------------------------------SSS---------------------------------------------------------------
----------------oooooo--------------------------------------------------------------------------------------------------------------------------------
------------------------------------------------------------------------------------------------------LLL---------------------------------------------
-------------------------------------------------UUUUU------------------------------------ooo---------------------------------------------------------
------------------------------------------------------------------------------------------ooo---------------------------------------------------y-----
-----------------tt*------*-----!!!!!--------%%-S-------------------------!-----*--------tt---------------------r-----*tt%%%%---tt-------%%%%tt-------
----------------%tt*--%%%%*tt---------------*%%---------------------------------*---tt%%%tt--------%%%-----------%%%%-*tt%%%%---tttt---tt%%%%tt---*---
------tt--------%tt*tt%%%%*tt-------------***%%------------LLLLUUUUU------------*---tt%%%tttt------%%%*-----@@---%%%%-*tt%%%%---tttt---tt%%%%tt---*---
M-----tt--------%tt*tt%%%%*tt---------y---***%%---------r-----------------------*---tt%%%tttt------%%%*---k------%%%%-*tt%%%%---tttt---tt%%%%tt---*-g-
XXXXXXXXXXXXXXXXXXXXXXXXXXXXXXXXXXXXXXXXXXXXXXX------XXXXXXXXXXXXXXXXXX--XXXXXXXX---XXXXXXXXXXXXXXXXXXX--XXXXXXXXXXXX-XXXXXXXXXXXXXX---XXXXXXXXXXXXXXX
XXXXXXXXXXXXXXXXXXXXXXXXXXXXXXXXXXXXXXXXXXXXXXX------XXXXXXXXXXXXXXXXXX--XXXXXXXX---XXXXXXXXXXXXXXXXXXX--XXXXXXXXXXXX-XXXXXXXXXXXXXX---XXXXXXXXXXXXXXX
