------------------------------------------------------------------------------------------------------------------------------------------------------
------------------------------------------------------------------------------------------------------------------------------------------------------
------------------------------------------------------------------------------------------------------------------------------------------------------
------------------------------------------------------------------------------------------------------------------------------------------------------
------------------------------------------------------------------------------------------------------------------------------------------------------
------------------------------------------------------------------------------------------------------------------------------------------------------
------------@@@------------------!!!!------ooo------------------------------------------------------UU--------------------------------------------@@@@
------------------------o------------------ooo---------SSSS-------------------------------------------------------------------------------------------
------------------------o------------------------------------------------------------ooooUU----------------CC----------------------ooo----------------
------------------------o--k-------------------------------ooo-----------------------oooo-------------------------------------g-----------------------
---------------------tt--tt-%%----------------*%---------*-ooo-----------------------oooo------SSSSS--------------@@ooo-----C-*----%%-----oooo--------
-------*--oo---------tt--tt-%%---tt--------%TT*%---------*%%%%-------------------oooo-----------------SS-r----------ooo!!!!!--*-ooo%%---------------tt
-------*--oo%%%%---tttt%%tt-%%---tt--------%TT*%------tt**%%%%-----UU--------------------%%%--------tt----%---------ooo-------*-ooo%%-UUUU----------tt
M------*----%%%%%%%tttt%%tt-%%-y-tt-----r--%TT*%------tt**%%%%ooooo----y-----%%%%--------%%%-g------tt----%----y----------%%%%*-ooo%%-----------y---tt
XXXXXXXX----XXXXXXXXXXXXXXX-XXXXXXXXXXX----XXXXX------XXXXXXXXXXXXXXXXXXXX---XXXXXXXXXXXXXXXXXXXXXXXXX-XXXX--------XXXXXXXXXXXX----XX-XXXXXXXXXXXXXXXX
XXXXXXXX----XXXXXXXXXXXXXXX-XXXXXXXXXXX----XXXXX------XXXXXXXXXXXXXXXXXXXX---XXXXXXXXXXXXXXXXXXXXXXXXX-XXXX--------XXXXXXXXXXXX----XX-XXXXXXXXXXXXXXXX
