------------------------------------------------------------------------------------------------------------------------------------------------------
------------------------------------------------------------------------------------------------------------------------------------------------------
------------------------------------------------------------------------------------------------------------------------------------------------------
------------------------------------------------------------------------------------------------------------------------------------------------------
----------------------------------------------------------------------------------------UUUUU---------------------------------------------------------
------------------------------------------------------------------------------------------------------------------------------------------------------
---------------------------------ooooo----------------------------------------------------------------------------------------------------------------
---------------------------------ooooo-----------------------------------ooo-----------------ooooLLL--------------------------------------------------
-----L---------------------------ooooo-----oooo----------------------------------------------oooo---ooo-----------------------------------------------
------------------------r------------------oooo----------------------------------------------oooo---ooo--------k---g----------------------k-----------
--------------------------*-------**-------oooo-----o-------------------------r--CCC---@---tt*------ooo----------%%---------------------*-------------
-------------------g------*---ooo-**----------------o-----tt*TT----------%%%----%----------tt*----%%--------*%%%%%%----!!!!oo-----------*-------------
-r-----------------tt**---*-oo----**----------------------tt*TT----------%%%----%----------tt*----%%---tt---*%%%%%%--------oo--------tt-*-------------
M-------y--g---r---tt**%%%*-------**-------------g--------tt*TT--k----g--%%%----%----r-----tt*----%%---tt---*%%%%%%--------oo--r-----tt-*------r----k-
XXXXXXXXXXXXXXXXXXXXXXXXXXXXXXXXXXXXXXXXXXXXXXXXXXXXXX----XXXXX----XXXXXXXXX----X---XXXXXXXXXX----XX---XX---XXXXXXXXXXXXXXXXXXXXXXXXXXX-X----XXXXXXX--
XXXXXXXXXXXXXXXXXXXXXXXXXXXXXXXXXXXXXXXXXXXXXXXXXXXXXX----XXXXX----XXXXXXXXX----X---XXXXXXXXXX----XX---XX---XXXXXXXXXXXXXXXXXXXXXXXXXXX-X----XXXXXXX--
