------------------------------------------------------------------------------------------------------------------------------------------------------
------------------------------------------------------------------------------------------------------------------------------------------------------
------------------------------------------------------------------------------------------------------------------------------------------------------
------------------------------------------------------------------------------------------------------------------------------------------------------
------------------------------------------------------------------------------------------------------------------------------------------------------
------------------------------------------------------------------------------------------------------------------------------------------------------
---------------------------------------------------------------------------------------------------------o--------------LLL---------------------------
-------oo-----------------------------LLLL--------------------------------------------------ooooo----ooooo--------------------------------------------
-------oo------------------------------------------------ooo------!!-------------UUUU-------ooooo----ooooo---------!!!!!---@@@@@------------oo--------
-------------------------------k-------------------------------------------------------------------g------------------------------------------------k-
!----------g-oooo--------SSSS--%%%-------------------------------------------tt*--------------------%%--------ooooo--------tt----y-*------------r---*-
-LLLooo%%%----------tt%--------%%%------*--------------g-*%-o-@@@@---r--tt%%*tt*---%--------------*-%%--**--r-ooooo--------tt----TT*--*-oooo%%%%tt--*-
----ooo%%%-----%%%--tt%------%%%%%oooo--*---------ooo---**%-o-----*---tttt%%*tt*tt*%----------tt--**%%tt**--**-----------tttt----TT*--*-oooo%%%%tttt**
M------%%%-----%%%%%tt%------%%%%%------*-------g-------**%-------*---tttt%%*tt*tt*%---k--k---tt--**%%tt**%%**-----------tttt----TT*--*-----%%%%tttt**
XXXXXXXXXXXXXXXXXXXXXXXXXXXXXXXXXXXXXXXXXXXXXXXXXXXXXXX-XXXXXXXXXXX---XXXXXXXXXXXXXXXXXXXXXXXXXX--XXXXXXXXXXXXXXXXXXXXXXXXXXX----XXX--XXXXXXXXXXXXXXXX
XXXXXXXXXXXXXXXXXXXXXXXXXXXXXXXXXXXXXXXXXXXXXXXXXXXXXXX-XXXXXXXXXXX---XXXXXXXXXXXXXXXXXXXXXXXXXX--XXXXXXXXXXXXXXXXXXXXXXXXXXX----XXX--XXXXXXXXXXXXXXXX
