------------------------------------------------------------------------------------------------------------------------------------------------------
------------------------------------------------------------------------------------------------------------------------------------------------------
------------------------------------------------------------------------------------------------------------------------------------------------------
------------------------------------------------------------------------------------------------------------------------------------------------------
------------------------------------------------------------------------------------------------------------------------------------------------------
------------------------------------------------------------------------------------------------------------------------------------------------------
-------------------------------------------------ooo------------------------------------------------ooo--------!!!!----------------------CCCC!!!!!----
CCC----------------------------------------------ooo----------------oo------------------------------ooo-----------------------------------------------
---LLLLL-----------------------------------------ooo----------------ooCC---------U--------------------------------------------------------------------
---------------------------------r---------------------------r--oooooo-------------y---------------------ooooo------------------------k---------------
-------%%%%--------!!!!UU------%%%-------------------------*----oooo----CCCCC-----*-----------------tt---ooooo!-------tt-------------*--------TTtt----
-------%%%%--------------------%%%%-------oo-------------*-*%%%%----%-------------*-----------------tt---ooooo--TT----tt----y--------*%-**----TTtt----
-------%%%%--------------------%%%%%%%----oo-------tt----***%%%%--tt%-----------@-*--CC-------------tttt*-------TT----tt--*----------*%***----TTttoooo
M------%%%%--r-----------------%%%%%%%--------k----tt%%%%***%%%%--tt%%--------g---*------k---r---g--tttt*-------TT%%%%tt--*----k-----*%***----TTtt----
XXX----XXXXXXXXXXXXXXXXXXXXXXXXXXXXXXXXXXXXXXXXXXXXXXXXXXXXXXXXX--XXXXXXXXX--XXXXXXXXXXXXXXXXXXXX---XXXXXXXXXXXXXXXXXXXX--X----XXX---XXXXX----XXXX----
XXX----XXXXXXXXXXXXXXXXXXXXXXXXXXXXXXXXXXXXXXXXXXXXXXXXXXXXXXXXX--XXXXXXXXX--XXXXXXXXXXXXXXXXXXXX---XXXXXXXXXXXXXXXXXXXX--X----XXX---XXXXX----XXXX----
