------------------------------------------------------------------------------------------------------------------------------------------------------
------------------------------------------------------------------------------------------------------------------------------------------------------
------------------------------------------------------------------------------------------------------------------------------------------------------
------------------------------------------------------------------------------------------------------------------------------------------------------
------------------------------------------------------------------------------------------------------------------------------------------------------
--------------------------------------------------------------------------------------------------------------------------------UUCCCCC---------------
------------------------------------------------------------------------------------------------------------------------------------------------------
------@@@------------------------------------C-------------------------------------------------oooo--------------------------@@------------UUUU-------
---------------------------------!!!-----------------------------------------------------------oooo------------------------------------oooo-----------
@@@!----------------LLLLL--------------------------------k-----S-------------g-----------------oooo------------------------y---o-------oooo-----------
----oo---SSSS-y-------------------ttU------y-------------tt--k-------------*-----------------k----*-----------k------------*---ott-%%%---------------%
---------------*--y---------------tt-------tt---------r--tt*--*------------*------%%%%---*%%%%---**--k-ooo-----tt-------oo-*---ott-%%%-*-------oo-%%%%
-----------%%%%*tt----------------tt-------tt---y-CC---tttt*%%*------------*------%%%%---*%%%%---**--tt--------tt---SSSSoo-*tttttt*%%%-*%%%*%%----%%%%
M-----%----%%%%*tt--------%-------tt---k---tt%%--------tttt*%%*------------*------%%%%---*%%%%---**--tt--------tt-r--------*tttttt*%%%%*%%%*%%----%%%%
XXXXXXXXXX-XXXXXXXXXXXXXXXXXXXXXXXXX-------XXXX-XXXXXXXXXXXXXXXXXXXX-------XXXXXXXXXXX---XXXXX---XX--XX-XXXXX--XX----XXXXXXXXXXXXXXXXXXXXXXXXXXXXXXXXX
XXXXXXXXXX-XXXXXXXXXXXXXXXXXXXXXXXXX-------XXXX-XXXXXXXXXXXXXXXXXXXX-------XXXXXXXXXXX---XXXXX---XX--XX-XXXXX--XX----XXXXXXXXXXXXXXXXXXXXXXXXXXXXXXXXX
