------------------------------------------------------------------------------------------------------------------------------------------------------
------------------------------------------------------------------------------------------------------------------------------------------------------
------------------------------------------------------------------------------------------------------------------------------------------------------
------------------------------------------------------------------------------------------------------------------------------------------------------
--------------------------------------C---------------------------------------------------------------------------------------------------------------
------------------------------------------------------------------------------------------------------------------------------------------------------
-------------C-------------------oo-------------------------------------------------------------!!!!!-------------------------------------------------
------!!!!!-------ooo------------oo---------------------------------------------------------------------------------------------------ooooo-----------
---o--------------ooo------------oo----@-------------------------------------------o---------------------------------CCC-------------------SSSSS------
---o-----------------LLLLoooo-------------y----k--------------------------------------y---------------------------------------------------------------
---oLLtt%%%--------------oooo--y------tt----tt*------------ooo------------------g-----tt--y-------%%%----------g-----------o--------*---*tt*---*-g----
------tt%%%oo%%%%-%%%%---oooo---*-----tt----tt*------------ooo-------------ooo-%%-----tttt----g-tt%%%---------%%%--------g-o--------*--**tt*---*%tt---
--!---tt%%%tt%%%%*%%%%----------**-@@@tt----tt*------------tt--------------ooo%%%%%%%*tttt-tt---tt%%%---ooooo-%%%LLLL--%%%%o--------*--**tt*-tt*%tt---
M-----tt%%%tt%%%%*%%%%----------**----tt----tt*--------%%%-tt--------------ooo%%%%%%%*tttt%tt---tt%%%-r-ooooo-%%%------%%%%%--------*--**tt*-tt*%tt---
XXXXXXXXXXXXXXXXXXXXXXXXX---XXXXXX----XXXXXXXXX-XXXXXXXXXX-XXXXXXXXXXXXX-XXXXXXXXXXXXXXXXXXXXXXXXXXXXXXXXX----XXXXXXX--XXXXX---XXXXXX--XXXXX-XXXXXXXXX
XXXXXXXXXXXXXXXXXXXXXXXXX---XXXXXX----XXXXXXXXX-XXXXXXXXXX-XXXXXXXXXXXXX-XXXXXXXXXXXXXXXXXXXXXXXXXXXXXXXXX----XXXXXXX--XXXXX---XXXXXX--XXXXX-XXXXXXXXX
