------------------------------------------------------------------------------------------------------------------------------------------------------
------------------------------------------------------------------------------------------------------------------------------------------------------
------------------------------------------------------------------------------------------------------------------------------------------------------
------------------------------------------------------------------------------------------------------------------------------------------------------
------------------------------------------------------------------------------------------------------------------------------------------------------
------------------------------------------------------------------------------------------------------------------------------------------------------
----------------------------------------------------------------SSSSS---------------------------------------------------------------------------------
--------------------------------------ooo-------------------------------------------------------------------------------------------------------------
--------------------------------------ooo----------------------------------------------------------------------------ooooo----------------------------
S----------------------------------------------oooo----------ooo-----------------------------------------------------ooooo----------------------------
--------------%-----------------g---------*----oooo-------%--ooo--------------------------r--------oooo------------------------------LLL------k-tt--oo
-------%%%----%*-----------------*-@@@%---*-----%%*-------%--ooo-tt---------r-------oooo-*---oooCCC------------ooo----------------*----------%%%tt----
-------%%%----%*%------------C---*----%-TT*-----%%*-------%----tttt----------tt-----oooo-*---ooo---------------oooSSS----%%%------*----------%%%tt----
M------%%%----%*%-----r----r-----*%%%%%%TT*-----%%*-------%----tttt----g-----tt--k----%%%*-------%%------y---r-ooo-------%%%------*----------%%%tt-o--
XXXXXXXXXX----XXXXXXXXXXX-----XXXXXXXXXXXXX-----XXX---XXXXX----XXXXXXXXXXXXXXXX----XXXXXXX-------XX-XXXXXXXX------XXXXXXXXXX-XXXXXXXXXXXXX---XXXXXXXXX
XXXXXXXXXX----XXXXXXXXXXX-----XXXXXXXXXXXXX-----XXX---XXXXX----XXXXXXXXXXXXXXXX----XXXXXXX-------XX-XXXXXXXX------XXXXXXXXXX-XXXXXXXXXXXXX---XXXXXXXXX
