------------------------------------------------------------------------------------------------------------------------------------------------------
------------------------------------------------------------------------------------------------------------------------------------------------------
------------------------------------------------------------------------------------------------------------------------------------------------------
------------------------------------------------------------------------------------------------------------------------------------------------------
-------------------------------------------------LLLLLCCCCC-----------------------------------------------L-------------------------------------------
----------------------------------------LLLLCCCCC-----------------------------------------------------------------------------------------------------
------------------------------------CCCC--------------------------------------------------------------------------------------------------------------
-------------------------------------------------------------------------------------------------------------------------------LLLLL------------------
----------------------SS-------------------------------------------------S------------------------SSS------------------------oo-----UU@@@@------------
---------------------------------------------------------------------------------------oo-y-oooo-------k--------k------------oo-----------------------
----------r-----*---------------oooo--*----tt-*%%%%---*-----g--------------------------oo-%%%%---------%%%%-----*-------%-----o----------------k------
UUUUU-%%%-------*---------------------*----tt%*%%%%---*------%-------------------------oo-%%%%--UU-----%%%%-r---*------*%----tt%%-------------%%%%*%--
------%%%-*-----*----------ooooo------*%%tttt%*%%%%---*------%%%---**----*--------!!!!!---%%%%-------%%%%%%tt-tt*------*%----tt%%-------------%%%%*%--
M-----%%%-*-----*----------------%%%%-*%%tttt%*%%%%---*------%%%---**--k-*----------------%%%%-------%%%%%%tt-tt*------*%----tt%%-------------%%%%*%--
XXXXXXXXX-XXXXXXXXXXXXXXXXXXX----XXXX-XXXXXXXXXXXXX---X-XXXXXXXXXXXXXXXXXXXXXXXXXX--------XXXX---XXXXXXXXXXXX-XXXXXXXXXXX----XXXXXXXXXXXXXXXXXXXXXXXXX
XXXXXXXXX-XXXXXXXXXXXXXXXXXXX----XXXX-XXXXXXXXXXXXX---X-XXXXXXXXXXXXXXXXXXXXXXXXXX--------XXXX---XXXXXXXXXXXX-XXXXXXXXXXX----XXXXXXXXXXXXXXXXXXXXXXXXX
