------------------------------------------------------------------------------------------------------------------------------------------------------
------------------------------------------------------------------------------------------------------------------------------------------------------
------------------------------------------------------------------------------------------------------------------------------------------------------
------------------------------------------------------------------------------------------------------------------------------------------------------
------------------------------------------------------------------------------------------------------------------------------------------------------
-------------------------------C--------------------------------------------------------------------------------------!!!!----------------------------
-------------------------------------SSSS-------------------------------------------------------------------------------------------------------------
--------------------------------------------------------------------------oooooCCCC------------------oooo------------------------oo-------------------
--------------------------------------------------------------------------ooooo-----------o----------oooo--------!!!------ooSSSSS---------------------
------------g----------------r------------------------------ooooo-------------------------o-----------------------------------------------------------
ooooo-------tt%%%-%----------%%%--SSS*------------------LLLLooooo-------------------------o----------------k--g--%%%----*----tt%%tt-----U--------%%---
--------%%%%tt%%%-%----------%%%-----*----------------------*-----------k----------------*-oo----%%%%%*-----tt---%%%oo--*----tt%%ttooooo---g---tt%%%%%
--------%%%%tt%%%*%-----ooo--%%%-----*-------------*--------**-----y--%%%-----%%%--------*-------%%%%%*-----tt---%%%oo--*%%%%tt%%ttooooo---*---tt%%%%%
M-------%%%%tt%%%*%----------%%%-----*-%%------k---*--------**---%%---%%%-----%%%-%%%%%%%*---%%%%%%%%%*-----tt---%%%----*%%%%tt%%tt--------*---tt%%%%%
XXXXXXXXXXXXXXXXXXX---XXXXXXXXXXXXXXXX-XXXXXXXXX---XXXXX----XX---XX---XXXXXXXXXXX-XXXXXXXX---XXXXXXXXXXXXXXXXXXXXXXX----XXXXXXXXXXXXXXXXXXXXXXXXXXXXXX
XXXXXXXXXXXXXXXXXXX---XXXXXXXXXXXXXXXX-XXXXXXXXX---XXXXX----XX---XX---XXXXXXXXXXX-XXXXXXXX---XXXXXXXXXXXXXXXXXXXXXXX----XXXXXXXXXXXXXXXXXXXXXXXXXXXXXX
