----------------------------------------------------------------------------------------------------------
----------------------------------------------------------------------------------------------------------
----------------------------------------------------------------------------------------------------------
----------------------------------------------------------------------------------------------------------
----------------------------------------------------------------------------------------------------------
----------------------------------------------------------------------------------------------------------
----------------------------------------------------------------------------------------------------------
----------------------------------------------------------------------------------------------------------
--o--o--o--o--o--o--o--o--o--o--o--o--o--o--o--o--o--o--o--o--o--o--o--o--o--o--o--o--o--o--o--o--o--o--o-
-o--o--o--o--o--o--o--o--o--o--o--o--o--o--o--o--o--o--o--o--o--o--o--o--o--o--o--o--o--o--o--o--o--o--o--
--o--o--o--o--o--o--o--o--o--o--o--o--o--o--o--o--o--o--o--o--o--o--o--o--o--o--o--o--o--o--o--o--o--o--o-
-o--o--o--o--o--o--o--o--o--o--o--o--o--o--o--o--o--o--o--o--o--o--o--o--o--o--o--o--o--o--o--o--o--o--o--
--M--#--#--#--#--#--#--#--#--#--#--#--#--#--#--#--#--#--#--#--#--#--#--#--#--#--#--#--#--#--#--#--#--#--F-
X##X##X##X##X##X##X##X##X##X##X##X##X##X##X##X##X##X##X##X##X##X##X##X##X##X##X##X##X##X##X##X##X##X##X##-
X##X##X##X##X##X##X##X##X##X##X##X##X##X##X##X##X##X##X##X##X##X##X##X##X##X##X##X##X##X##X##X##X##X##X##-
X##X##X##X##X##X##X##X##X##X##X##X##X##X##X##X##X##X##X##X##X##X##X##X##X##X##X##X##X##X##X##X##X##X##X##-
