------------------------------------------------------------------------------------------------------------------------------------------------------
------------------------------------------------------------------------------------------------------------------------------------------------------
------------------------------------------------------------------------------------------------------------------------------------------------------
------------------------------------------------------------------------------------------------------------------------------------------------------
---------------------------------------------------------------------------------------------------LLL------------------------------------------------
------------------------------------------------------------------------------------------UUUUU----------------!--------------------------------------
----------------------------------------------------------ooooo-------------------------------------------------------------------------------------o-
------------------------------ooo------------------------------------------------------------------------------------------------------!!!-@@@@@----o-
-----!!!---------Soo----------ooo------------ooooo-----------------o-----------------ooooo--------------------o-------------Sooo--------------------o-
------------------oo-oooCCC---ooor@@@@-------ooooo------------------!!-----------UUUU-----------oo----r----oo---ooo----------ooo----------------oo----
------------------oo------------%%--------oortt------tt-----%%%g--------tt--------------tt------oo--%%%%%%%oo-----------tt*-----TT-%%%%-tt-tt---oo----
---------r---o------r-----------%%----ooo---%tt------tt-%%--%%%%%%%%%%%-tt--------------tt--%--r----%%%%%%%oo-%%%%%%----tt*-%%%-TT-%%%%-tt-tt---%---%%
--------tt---o-oo%%-tt-%%%%---tt%%----ooo---%tt------tt-%%--%%%%%%%%%%%-tt%-------%%----tt--%--%%%--%%%%%%%---%%%%%%----tt*-%%%-TT-%%%%-tt-tt-tt%---%%
M---k--%tt---ogoo%%-tt-%%%%--ytt%%---%ooo---%tt------tt-%%--%%%%%%%%%%%%tt%-----k-%%-%%%tt--%--%%%k-%%%%%%%--k%%%%%%----tt*-%%%-TT-%%%%-ttytt-tt%-k-%%
XXXXXXXXXXXXXXXXXXXXXXXXXXXXXXXXXXXXXXXXXXXXXXXXXXXXXXXXXXXXXXXXXXXXXXXXXXXXXXXXXXXXXXXXXXXXXXXXXXXXXXXXXXXXXXXXXXXXXXXXXXXXXXXXXXXXXXXXXXXXXXXXX-XXXX
XXXXXXXXXXXXXXXXXXXXXXXXXXXXXXXXXXXXXXXXXXXXXXXXXXXXXXXXXXXXXXXXXXXXXXXXXXXXXXXXXXXXXXXXXXXXXXXXXXXXXXXXXXXXXXXXXXXXXXXXXXXXXXXXXXXXXXXXXXXXXXXXX-XXXX
