------------------------------------------------------------------------------------------------------------------------------------------------------
------------------------------------------------------------------------------------------------------------------------------------------------------
------------------------------------------------------------------------------------------------------------------------------------------------------
------------------------------------------------------------------------------------------------------------------------------------------------------
------------------------------------------------------------------------------------------------------------------------------------------------------
------------@@@@@----------LLLLLL-----SSSSS-------------------------------------------------------------------------ooo-------------------------------
----------oo-----------oooo-------------------------oooo-------------------------------------oo---@@@@@----oooooooo-ooo-------------------------------
----------oo-----------oooo-------------------------oooo--------oo---------------------------oo------------oooooooo-ooo-------------------------------
----------oo-------------------------------oo-------------------oo----ooooo-----ooooo--------------------------------------oooo---------------o-------
-------------------------------------------oo-----!!------------ooL---ooooo-----ooooo----------g-------------------y-------oooo-----------------------
----------%%%%%%--%----%%%TT-----o----tt---oo-----------------------------------------ooo--TT%%%%--%----tt-------%%%%----------------%---%%%%y--------
---------g%%%%%%--%----%%%TT----------tt--------%----tt------------o----------o------rooo--TT%%%%tt%----tt------*%%%%---o------------%---%%%%tt-------
--------%%%%%%%%--%----%%%TT----------tt---tt---%----tt%%%%-----%%%%SS%%%%-g--------tt-----TT%%%%tt%---ott------*%%%%----CC----------%---%%%%tt!!!!!!!
M-------%%%%%%%%-y%----%%%TT--------%rtt---ttk--%----tt%%%%-----%%%%--%%%%%%%--y----tt-%%%-TT%%%%tt%---ott%%%%--*%%%%--------%-y---g-%---%%%%tt-------
XXXXXXXXXXXXXXXXXXXXXXXXXXXXXXXXXXXXXXXXXXXXXXXXXXXXXXXXXXXXXXXXXXXXXXXXXXXXXXXXXXXXXXXXXXXXXXXXXXXXXXXXXXXXXXXXXXXXXXXXXXXXXXXXXXXXXXXXXXXXXXXXXXXX--
XXXXXXXXXXXXXXXXXXXXXXXXXXXXXXXXXXXXXXXXXXXXXXXXXXXXXXXXXXXXXXXXXXXXXXXXXXXXXXXXXXXXXXXXXXXXXXXXXXXXXXXXXXXXXXXXXXXXXXXXXXXXXXXXXXXXXXXXXXXXXXXXXXXX--
