------------------------------------------------------------------------------------------------------------------------------------------------------
------------------------------------------------------------------------------------------------------------------------------------------------------
------------------------------------------------------------------------------------------------------------------------------------------------------
------------------------------------------------------------------------------------------------------------------------------------------------------
-------------------------------------------------------------------------------------------------------------------------------ooo--------------------
--------------------------------------------------------------LL---------------------------------------------------------------ooo-oooo---------------
--------------------------ooooo------------------------------------------------------------------------------------------------ooo-oooo---------------
--------------------------ooooo------------------@@@@----------------------------------------@@@@@----------------------------------------------------
-----------------------------------------CC---------------------------------------------------------------------------------------------LLL-----------
-------------k-----------------CC------oo----------------------------------------------o----------!!!----------------------------------y--------------
-------%%%%%%%--------------%%---------oo----------%-y----oook--yooo-o------*-----LL%--ork----%%%%-----------*-----------------tt----%%%%%%------tt---
--U----%%%%%%%-----ooo!!!!*-%%-------TT--------L---%tt---Sooo%%%%%%%-o------*-------%-%%%%----%%%%*----%----o*-oo--------------tt----%%%%%%------tt---
-------%%%%%%%---ttooo----*-%%-------TT------------%tt----ooo%%%%%%%-o------*-------%-%%%%%%%%%%%%*----%-----*koo-----------S--tt-ktt%%%%%%ooooo-tt---
Mk-----%%%%%%%-y-ttooo%%%-*-%%---r---TT-------%%r--%tt--r----%%%%%%%r-g-----*----r--%-%%%%%%%%%%%%*----%-----*%--r-----------yktt-%tt%%%%%%------tt---
XXXXXXXXXXXXXXXXXXX---XXXXXXXXXXXXXXXXXXXXXXXXXXXXXXXXXXXXXXXXXXXXXXXXXXXXXXXXXXXXXXXXXXXXXXXXXXXXXXXXXXXXXXXXXXXXXXXXXXXXXXXXXXXXXXXXXXXXXXXXXXXXX-XX
XXXXXXXXXXXXXXXXXXX---XXXXXXXXXXXXXXXXXXXXXXXXXXXXXXXXXXXXXXXXXXXXXXXXXXXXXXXXXXXXXXXXXXXXXXXXXXXXXXXXXXXXXXXXXXXXXXXXXXXXXXXXXXXXXXXXXXXXXXXXXXXXX-XX
