------------------------------------------------------------------------------------------------------------------------------------------------------
------------------------------------------------------------------------------------------------------------------------------------------------------
------------------------------------------------------------------------------------------------------------------------------------------------------
------------------------------------------------------------------------------------------------------------------------------------------------------
----------------------------------------------CCCC-------------------------------------------------------------@@@@@----------------------------------
-------------------------------------------------------------------------------------------UUUUU------------------------------------------------------
----------------------------------------------------------------------------------------------------@@----------------------------------!!!!!---------
---------------ooo----------------------------------U-@@------------UUUU---------------------------------------------@@--oooooLLLL-----------o--------
------o-LL-------------------@@@--------------------------------ooo---------------------------------------UUUU-----------ooooo-----CCCCo-----o--------
------o-------------L-----!!--------k-------------rg-g---------@ooo-----------------------------r-----rooo---------------ooooo---------o-----o@@@-----
-------y-----------o--Uo-----tt----%%*--------tt-tt%%%----------ooo----------------tt---------%-%----%%ooo---------%-----------------*----------------
------tt-------%--go-k-------tt----%%*--------tt-tt%%%tt-------------tt------------tt*--------%-%ooo-%%ooo----%%*tt%y----%%----------*----------tt-ooo
------tt-------%-*tt%%%%----ktt----%%*-tt-tt--tt-tt%%%tt--------tt---tt------------tt*--------%-%----%%-------%%*tt%tt---%%---tt-----*-TT-%%-%%%tt-ooo
M----ktt%----yg%-*tt%%%%g--%%tt----%%*-tt-tt--tt%tt%%%tt--------tt%--tt-%%%-------ytt*y---k---%-%----%%-------%%*tt%tt-y-%%---tt--r--*-TT-%%-%%%tt%%--
XXXXXXXXXXXXXXXXXXXXXXXXXXXXXXXXXXXXXXXXXXXXX-XXXXXXXXXXXXXXXXXXXXXXXXXXXXXXXXXXXXXXXXXXXXXXXXXXXXXXXXXXXXXXXXXXXXXXXXXXXXXXXXXXXXXXXXXXXXXX-XXXXXXXXX
XXXXXXXXXXXXXXXXXXXXXXXXXXXXXXXXXXXXXXXXXXXXX-XXXXXXXXXXXXXXXXXXXXXXXXXXXXXXXXXXXXXXXXXXXXXXXXXXXXXXXXXXXXXXXXXXXXXXXXXXXXXXXXXXXXXXXXXXXXXX-XXXXXXXXX
