------------------------------------------------------------------------------------------------------------------------------------------------------
------------------------------------------------------------------------------------------------------------------------------------------------------
------------------------------------------------------------------------------------------------------------------------------------------------------
------------------------------------------------------------------------------------------------------------------------------------------------------
------------------------------------------------------------------------------------------------------------------------------------------------------
-------------------@---------------------------------------------------------------------------------------------------------@@-----------------------
----------------------------------------ooooo------------------------------------------------------------!!-----@@@-----------------------------------
------oooo-@@@@-------------------------------oooo-------------------------CCCCC------------------------------------------------------------------!!!!
------oooo----------CCCCC--------------------------------C-----------------------------@@@@-------------------------CCC----U------UU------------------
------------------------------------o----------------------o---oo---------------------------r------!!!ooo----------g----------------r-----------------
----------y-----%--%-----%%%%-------o---%%-----*-----------o---oo---------%------oooo-------ttk-------ooo---------tt%%-g-----*-----%%--------tt--tt---
----------*-----%--%-----%%%%-----------%%---r-*------*----o-@-oo---------%------oooo-------tt%---------%---------tt%%tt----o*-----%%---oo---tt--tt---
--------tt*tt---%TT%-----%%%%-%%%-------%%-%%%%*------*-------------------%--tt-r----------gtt%--------*%tt-------tt%%tt----o*tt---%%---oo---tt--tt---
M----r--tt*tt--r%TT%-----%%%%-%%%--k-y--%%-%%%%*--g---*-g-r-r-r---%-------%--tt%%-%%%g----%%tt%---y----*%tt-------tt%%tt%%%%o*ttry-%%--y-----tt--tt%%%
XXXXXXXXXXXXXXXXXXXXXXXXXXXXXXXXXXXXXXXXXXXXXXXXXXXXXXXXXXXXXXXXXXXXXXXXXXXXXXXXXXXXXXXXXXXXXXXXXXXXXXXXXXXXXXXXXXXXXXXXXXXXXXXX--XXXXXXXXXXXXX--XXXXX
XXXXXXXXXXXXXXXXXXXXXXXXXXXXXXXXXXXXXXXXXXXXXXXXXXXXXXXXXXXXXXXXXXXXXXXXXXXXXXXXXXXXXXXXXXXXXXXXXXXXXXXXXXXXXXXXXXXXXXXXXXXXXXXX--XXXXXXXXXXXXX--XXXXX
