------------------------------------------------------------------------------------------------------------------------------------------------------
------------------------------------------------------------------------------------------------------------------------------------------------------
------------------------------------------------------------------------------------------------------------------------------------------------------
------------------------------------------------------------------------------------------------------------------------------------------------------
--------------------oo---------------------------------------------------------------------------------------LL-----------------------------LLLLL-----
--------------------oo-------------------------------------------------------------!!!!-----CC--------------------------------------------------------
--------------------oo------LLLLL--------------------------------------------------------------------------------LLL----------------------------------
-------@@@--------------------------------SSS------------------------------------------ooooo----------------------------------------------------------
---------------------------------------------------------o-----------------------------ooooo---------------------------oo-ooo-------------------------
-------------------y-----o---------------------------SSSSo-----y----------------------------------------oooo-----------oo------------ooooooo----------
-------------------TT---y--------------------------------o-----%%%%------------------*----%%%-----------oooo-*----%-----%----------U-tt---------*%----
-------------------TT---ttCk--------------------oooo-----------%%%%-------*-ooooo----*----%%%--------SSS-----*----%-----%--*-----%%--tt---------*%----
--------%%%--------TT-y-tt-%%tt---tt--------tt--oooo-tt--------%%%%-------*yooooo----*----%%%----------------*----%-----%--*-----%%*-tt---------*%-tt-
M-----g-%%%--------TT-%%tt-%%tt---tt--------tt-g-----tt---ry---%%%%----g--*%------k--*----%%%-g-----%%%%%%%-g*-yk-%-k-k-%--*-----%%*rtt---------*%-tt%
XXXXXXXXXXXXXXXXXXXXXXXXXXXXXXXXXXXXXXXXXXXXXXXXXXXXXXXXXXXXXXXXXXXXXXXXXXXXXXXXXXXXXXXXXXXXXXXXXXXXXXXXXXXXXXXXXXXXXXXXXXXXXXXXXXXXXXXXXXXXXXX-XXXXXX
XXXXXXXXXXXXXXXXXXXXXXXXXXXXXXXXXXXXXXXXXXXXXXXXXXXXXXXXXXXXXXXXXXXXXXXXXXXXXXXXXXXXXXXXXXXXXXXXXXXXXXXXXXXXXXXXXXXXXXXXXXXXXXXXXXXXXXXXXXXXXXX-XXXXXX
