------------------------------------------------------------------------------------------------------------------------------------------------------
------------------------------------------------------------------------------------------------------------------------------------------------------
------------------------------------------------------------------------------------------------------------------------------------------------------
------------------------------------------------------------------------------------------------------------------------------------------------------
--------------------------o-----------------------------------------------------------------------SS--CCC---------------------------------------------
--------------------------o-------------------------------------------------@@-----------------------o------------------------------------------------
--------------------------o--------------------------------------------------------------------------o------------------------------------------------
------------------L-----------------------------------------------------------------------------------------------------------------------------------
-----------------------CCC--------------------------!!---------------@@@-oo------------------------------------------------------LL---------UU--------
---oooooy----------kg----------SS-----------------oo---------------------oog-------------------ooo--r-------------!--------ooooo----------------------
---ooooott--------%%%%---tt-----------ooo----tt%------------------------r%%%%------------------%%%%%%%%----------------------tt-r------SSSS----*------
---ooooott--------%%%%---tt------g----ooo---%tt%------oooo-------------tt%%%%--------%%--------%%%%%%%%------------%--------%tt-%%%%-----------*tt----
--------tt--------%%%%---tt----%%%%---ooog--%tt%---*tt----%%-----------tt%%%%--------%%---LLLL-%%%%%%%%--------k---%--------%tt-%%%%ooo--------*tt----
M-g-----tty-------%%%%---ttg--k%%%%-%%%%%%--%tt%-r-*tt----%%-------yr--tt%%%%-r------%%--y----g%%%%%%%%--g-----%%%%%--------%tt-%%%%-----%-g--k*tt----
XXXXXXXXXXXXXXXXXXXXXXXXXXXXXXXXXXXXXXXXXXXXXXXXXXXXXXXXXXXXXXXXX----XXXXXXXXXXXXXXXXXXXXXXXXXXXXXXXXXXXXXXXXXXXXXXXXXXXXXXXXXXXXXXXXXXXXXXXXXXXXX---X
XXXXXXXXXXXXXXXXXXXXXXXXXXXXXXXXXXXXXXXXXXXXXXXXXXXXXXXXXXXXXXXXX----XXXXXXXXXXXXXXXXXXXXXXXXXXXXXXXXXXXXXXXXXXXXXXXXXXXXXXXXXXXXXXXXXXXXXXXXXXXXX---X
