------------------------------------------------------------------------------------------------------------------------------------------------------
------------------------------------------------------------------------------------------------------------------------------------------------------
------------------------------------------------------------------------------------------------------------------------------------------------------
------------------------------------------------------------------------------------------------------------------------------------------------------
-----------------------------------------------------L------------------------------------------------------------------------------------------------
------------------------------------------------------------------UUU---------------------------------------------------------------------------------
----------------------------------------!!!!!!--------oo-ooo------------------------------------------------------------------------------------------
---------------------------------------------------oo-oo-ooo---------oooooooo-----------------oooo-S--------------------------------------------------
---------oooo!!!!--------------ooooo---------------oo----ooo----------------------------------oooo---oooooooooo-----------ooo---------oooooooooo------
--------yoooo----oooo----------ooooo-ooo------r------------------------------------------------------oooooooooo--------------!!!!!--------------------
-----%%%%oooo----oooo----------ooooo-ooo-----%%%%%%%-%%------*----------------------%%---%SSSS-------oooooooooo----------k---------SSS------%%%%-----t
-----%%%%-tt----------%%%------------ooo-----%%%%%%%-%%-r----*-----%tt%%%%tt--------%%-tt%--------y%-----------r-%%%%-%%tt----------------tt%%%%LLL--t
-----%%%%-tt%%--------%%%-----tt----y--------%%%%%%%-%%%%%%%-*-----%tt%%%%tt-L------%%-tt%-------tt%----tt--%%%%-%%%%-%%tt%%%%----o-------tt%%%%-----t
M----%%%%-tt%%-------g%%%---%%tt--%%%%%%%----%%%%%%%-%%%%%%%y*--r--%tt%%%%tt---kooo-%%-tt%-------tt%y---tt--%%%%-%%%%-%%tt%%%%-%-%o-------tt%%%%---y-t
XXXXXXXXXXXXXXXXXXXXXXXXXXXXXXXXXXXXXXXXXXXXXXXXXXXXXXXXXXXXXXXXXXXXXXXXXXXXXXXXXXXXXXXXXXXXXXXXXXXXXXXXXXXXXXXXXXXXXXXXXXXXXXXXXXXXXXXXXXXXXXXX----XX
XXXXXXXXXXXXXXXXXXXXXXXXXXXXXXXXXXXXXXXXXXXXXXXXXXXXXXXXXXXXXXXXXXXXXXXXXXXXXXXXXXXXXXXXXXXXXXXXXXXXXXXXXXXXXXXXXXXXXXXXXXXXXXXXXXXXXXXXXXXXXXXX----XX
