------------------------------------------------------------------------------------------------------------------------------------------------------
------------------------------------------------------------------------------------------------------------------------------------------------------
------------------------------------------------------------------------------------------------------------------------------------------------------
------------------------------------------------------------------------------------------------------------------------------------------------------
-----------------------------------------------------------------------------------ooooo--------------------------------------------------------------
-----------------UUUUU----------------------------CC-------------------------------ooooo--------------------------------------------------------------
-----------------------oooo--------------------------------------@-----------------ooooo---CC------------------------------------------------SSSS-----
-----------------------oooo------------------------------------------------------------------------------------------------oo-------------------------
-----C-@@-ooo-----------------------------------oo---!-----CCCCC-------------------------------------------------------ooo----UUUUU-------------------
----------ooo---------g-----oooo-!!-----------------------------o---yLLLLL--------g------------------------oooo-----------y----------o-----oo---------
-------------koo--%---%%%%---------ooo--%-----------------%-----o%%%%-------------%%%%%%%%-%%%%%%%----oooo---*----------%-%%%-%%%%---o-----oo---------
------g--y--%%--y-%---%%%%---%%%-%%-----%------L-tt-------%-----o%%%%tt-------%%%%%%%%%%%%-%%%%%%%-----------*tt--------%-%%%-%%%%-----ooo-oo-tt----tt
------%%%%--%%-tt-%---%%%%---%%%-%%-----%-----o--tt-------%------%%%%tt-------%%%%%%%%%%%%-%%%%%%%tt%-----y--*tt--%%%---%-%%%-%%%%------%-----tt--%-tt
M---k-%%%%--%%-tt-%---%%%%-k-%%%k%%---r-%-----o--tt%k-----%------%%%%tt-------%%%%%%%%%%%%o%%%%%%%tt%-----%%-*tt--%%%-g-%-%%%g%%%%-g%-r-%-k---tt--%-tt
XXXXXXXXXXXXXXXXXXXXXXXXXXXXXXXXXXXXXXXXXXXXXXXXXXXXXXXXXXXXXXXXXXXXXXXXXXXXXXXXXXXXXXXXXXXXXXXXXXXXXXXXXXXXXXXXXXXXXXXXXXXXXXXXXXXXXXXXXXXXXXXX--XXXX
XXXXXXXXXXXXXXXXXXXXXXXXXXXXXXXXXXXXXXXXXXXXXXXXXXXXXXXXXXXXXXXXXXXXXXXXXXXXXXXXXXXXXXXXXXXXXXXXXXXXXXXXXXXXXXXXXXXXXXXXXXXXXXXXXXXXXXXXXXXXXXXX--XXXX
