------------------------------------------------------------------------------------------------------------------------------------------------------
------------------------------------------------------------------------------------------------------------------------------------------------------
------------------------------------------------------------------------------------------------------------------------------------------------------
------------------------------------------------------------------------------------------------------------------------------------------------------
------------------------------------------------CCCCC------------------------------------------------------------------------------------------@------
------------------------------------------------------------------------------------------------------------------------------------------------------
------------------------ooooo-----------------------------------------------@@@@@--@------------------------------------------------------------------
---------------------------------------------ooo------------------ooo------------oo----------------------CCCCCCC---------------------------------@@@@@
-----------------------------@@----------@@@@ooo---------------@@@----ooo--------oo-------@@@@--------------------oo-------!!-------------ooooo-------
---------------------------------------------ooo----------------------ooo--------oo-o----------oo-----------------oo---oo-----------------ooooo-------
---------ooooor------------%%%%--o--%%--------%%%%%%-----------------rooo------------tt-oo----------ooooo---------oo---oo-------------------%%%%------
--------------%%%%%%--%%%--%%%%--o--%%--------%%%%%%-------o--o---tt%%%-------tt-----tt-oo--tt---g--ooooo------tt---------------o-----------%%%%----%-
----%-----tt--%%%%%%tt%%%--%%%%-----%%--------%%%%%%-------oy@o---tt%%%-tt--%-tt%%%%%tt-----tt---tt------------tt---------------o-%%%-------%%%%----%-
M---%---k-tt--%%%%%%tt%%%--%%%%or-g-%%--------%%%%%%------g%%-o---tt%%%-tt%%%-tt%%%%%tt-----tty-%tt--------%%%-tt---k------------k%%%----o--%%%%g---%-
XXXXXXXXXXXXXXXXXXXXXXXXXXXXXXXXXXXXXXXXXXXXXXXXXXXXXXXXXXXXXXXXXXXXXXXXXXXXXXXXXXXXXXXXXXXXXXXXXXXXXXXXXXXXXXXXXXXXXXXXXXXXXXXXXXXXXXXXXXXXXXXX----XX
XXXXXXXXXXXXXXXXXXXXXXXXXXXXXXXXXXXXXXXXXXXXXXXXXXXXXXXXXXXXXXXXXXXXXXXXXXXXXXXXXXXXXXXXXXXXXXXXXXXXXXXXXXXXXXXXXXXXXXXXXXXXXXXXXXXXXXXXXXXXXXXX----XX
