------------------------------------------------------------------------------------------------------------------------------------------------------
------------------------------------------------------------------------------------------------------------------------------------------------------
------------------------------------------------------------------------------------------------------------------------------------------------------
------------------------------------------------------------------------------------------------------------------------------------------------------
------------------------------------------------------------------------------------------------------------------------------------------------------
------------------------------------------------------------------------------------------------------------------------------------------------------
------------------------------------------------------------------------------------------------------------------------------------------------------
------------------------------------------------------------------------------------------------------------------------------------------------------
-----------------oSooo----------------ooSooSoo--------------------------------------------------------------------------------------------------------
---------------------------------------------------------------------------------------------------------oSoo-----------------------------------------
------------------oooo----------------ooooooo-------------oSoSo------------------------------oooSoo---------------------------------------------------
---------------K---g--------------------k---g----Soo---------------%%%%%----------------------------------ooo---------------------------ooooSSo--oooo-
--------------XXXXXXXXX-ooo-----oo---XXXXXXXXXX-------------oo-----|||Y|------XX---------------oooo----------------Tt--tt-----------------------------
--------------XXXXXXXXX---r----------XXXXXXXXXX----oooo----------XXXXXXXXXXXXXXXXXX--XXXXXXX-----k----XXXXXXXXXXX--Tt--tt----*---------oooooooo-------
XXXXXXXXXXXX--XXXXXXXXXXXXXXXXXXXXXXXXXXXXXXXXX---r-----XXXXXXXXXXXXXXXXXXXXXXXXXXX--XXXXXXXXXXXXXXXXXXXXXXXXXXXXXXXXXXXXXXXXXX---------------y--r----
XXXXXXXXXXXXXXXXXXXXXXXXXXXXXXXXXXXXXXXXXXXXXXXXXXXXXXXXXXXXXXXXXXXXXXXXXXXXXXXXXXX--XXXXXXXXXXXXXXXXXXXXXXXXXXXXXXXXXXXXXXXXXXXXXXXXXXXXXXXXXXXXXXXXX
