------------------------------------------------------------------------------------------------------------------------------------------------------
------------------------------------------------------------------------------------------------------------------------------------------------------
------------------------------------------------------------------------------------------------------------------------------------------------------
------------------------------------------------------------------------------------------------------------------------------------------------------
--------------------------------------------UUUU------------------------------------------------------------------------------------------------------
---------------------------------------------------------------------------CCCC-----------------------------------------------------------------------
--------------------------------------------------------C------------------------------------------------------------------------UUUUU----------------
---------------------------------!!!------------------------------------------------------------------------------------------------------------------
---------------------------------------------------C------------------ooooo-----------------------------------------------------------------------CCCC
--------@@@@@------SS----------------------------k-------ooooo--------ooooo---------------------------------------------------------------------------
oooo%%%%---------oo--ooo------tttt-------------tt---oooo-ooooo---CCCC@ooooo------------------tt----------------tt-------------------------LLLLL-------
----%%%%-------ttoo--ooo------tttt-----------TTtt------tttttt-S---------------%----o---------tt----------------tt--r----------k-----------------------
----%%%%-----%%ttoo--ooo------tttt-----------TTtt------tttttt-----------------%----oCCC------tt--------------tttttt----------%%%%%--------------------
M---%%%%--%%%%%tt-------------tttt----y---g--TTtt------tttttt%-oo%%%%---------%--y-o------r--tt---------y----tttttt----------%%%%%--------------y-----
XXXXXXXX--XXXXXXX----XXXXXXXX-XXXXXXXXXXXXXXXXXXXXXXXXXXXXXXXX---XXXX-XXXXXXXXX---XXXXXXXXXXXXX------XXXX----XXXXXXXXXXXXXXXXXXXXX----XXXXXXXXXXXXXXXX
XXXXXXXX--XXXXXXX----XXXXXXXX-XXXXXXXXXXXXXXXXXXXXXXXXXXXXXXXX---XXXX-XXXXXXXXX---XXXXXXXXXXXXX------XXXX----XXXXXXXXXXXXXXXXXXXXX----XXXXXXXXXXXXXXXX
