------------------------------------------------------------------------------------------------------------------------------------------------------
------------------------------------------------------------------------------------------------------------------------------------------------------
------------------------------------------------------------------------------------------------------------------------------------------------------
------------------------------------------------------------------------------------------------------------------------------------------------------
------------------------------------------------------------------------------------------------------------------------------------------------------
------------------------------------------------------------------------------------oooo--------------------------------------------------------------
------------------o-----------------------------------------------------------------oooo--------------------------------------------------------------
-------------------------------------------oooo---o----------o-----ooooo--------------------------------!!!!!-------------oooooo----------------------
-------------------------------------------oooo--------------o-----ooooo------S-------------------------------------------oooooo----------------------
-------------y------g----CCC--------SSS----oooo-k-----SSS------------------------y-----------!!!!-----k-------------------------------------!!!!!-----
--g--ooo------tt--tt----------k----------k-tt---tt--g------------------------------tt-------------y----tt--------k------------------------------------
tt------------tt--tt-oooo---tt---------%%--tt---tt%%--tt--------g--------r--y--%%--tt------------tt----tt----%%------------tt----r----------tt--------
tt------tt----tt--tt--------tt---------%%--tt---tt%%--tt-----tt-----tt%%%%%%%--%%--tt----o-y-----tt----tt----%%----tt------tt----tt@@-------tt--------
tt------tt----tt--tt%%%-----tt----y----%%--tt-%%tt%%--tt---r-tt%%%--tt%%%%%%%--%%--tt---k---%%%--tt----tt----%%----tt--g---tt%%--tt----y---rtt----y--y
XX----XXXXXXXXXXXXXXXXX--XXXXX--XXXXXXXXXXXXX-XXXXXXXXXX--XXXXXXXXXXXXXXXXXXXXXXX--XX--XXXXXXXX--XXXX--XX----XXXX--XXXXXXXXXXXX--XXXXXXXXXX-XXXXXX----
XX----XXXXXXXXXXXXXXXXX--XXXXX--XXXXXXXXXXXXX-XXXXXXXXXX--XXXXXXXXXXXXXXXXXXXXXXX--XX--XXXXXXXX--XXXX--XX----XXXX--XXXXXXXXXXXX--XXXXXXXXXX-XXXXXX----
