------------------------------------------------------------------------------------------------------------------------------------------------------
------------------------------------------------------------------------------------------------------------------------------------------------------
------------------------------------------------------------------------------------------------------------------------------------------------------
------------------------------------------------------------------------------------------------------------------------------------------------------
------------------------------------------------------------------------------------------------------------------------------------------------------
-----------------------------------------------------UUU-----------LLLLS------------------------------------------------oo----------------------------
------------------------------------------------------------------------o--------------------oooo-------UUUUU-----------oo----@@@@@ooooo--------------
------------------o-----------------------------------------------------o--------------------oooooooo---------------------oooo-----ooooo-------------o
CC---@@-----------o-----------------------------------------------------o--------------------oooo----------------------------------ooooo-------------o
--ooo-------------oooooo----------------------LLLLooo------------------------------------------------------------------------------------------------o
--------------------------------------------------ooo------SSSS------%%%%--------------tt--------%%-------------o-------%%%--------%%%%----U-----!!!!-
-------oo-------y--------k-------------------!------tt---------oooo--%%%%tt---------g--tt---TT---%%------%%%-ooo----Uooo%%%-------%%%%%-ooo-----------
----%%%%%ooo-----tt----%%%%----------%%%%%----tt----tt---------oooo--%%%%tt--------%%%%tt---TT---%%------%%%-ooo-ooo-ooo%%%-------%%%%%-ooo---k-------
M---%%%%%----y---tt----%%%%--------y-%%%%%----tt----tt---------------%%%%tt--------%%%%tt---TT---%%---k--%%%-ooo--------%%%-------%%%%%----%%%------%%
XXXXXXXXX----XXX-XXXXXXXXXXXXXXXX----XXXXXXXXXXXXXXXXX---XXXXXXXXXX--XXXXXXXXXX----XXXXXX---XX---XX------XXXXXXXXXXXXXXXXXXXXXXXXXXXXXXXXXXXXXXXXXXXXX
XXXXXXXXX----XXX-XXXXXXXXXXXXXXXX----XXXXXXXXXXXXXXXXX---XXXXXXXXXX--XXXXXXXXXX----XXXXXX---XX---XX------XXXXXXXXXXXXXXXXXXXXXXXXXXXXXXXXXXXXXXXXXXXXX
