------------------------------------------------------------------------------------------------------------------------------------------------------
------------------------------------------------------------------------------------------------------------------------------------------------------
------------------------------------------------------------------------------------------------------------------------------------------------------
------------------------------------------------------------------------------------------------------------------------------------------------------
------------------------------------------------------------------------------------------------------------------------------------------------------
-------------------------------@-----UUU--------------------------------------------------------------------------------------------------------------
--------------------------------ooooo-----------------------------------------------------------------------------------------------------------------
--------------------------------ooooo---------ooo--------------------------------------------------!!!------------------------------------------------
----UUUUU-------------------------------------ooo--ooooo--ooooo------------ooo---------------------------------!!!---------------------------------ooo
-----------ooooooo---------g-----------------------ooooo--ooooo---oooo-----ooo---------UUUUU------------r-----------------!!!----------o--------------
--------------------k---------tt-----------------C-ooooo--ooooo-----------------------------------------tt------------k----------o-----o--y----k----%%
-----------------%%%%---------tt--%%%%--------tt----------------y-tt----g---tt------y-------------------tt--------tt----------y--o-----o---tt-tt%%%-%%
--y--------------%%%%tt-------tt--%%%%--g--r--tt----------------%%tt-----tt-tt-----%%%%%%%---------%%---tt-o------tt-------%%%---o---------tt-tt%%%-%%
M---%-----y------%%%%tt-------tt--%%%%--%%----tt--g-%%---y------%%tt-----tt-tt--r--%%%%%%%-----k---%%---tt---r----tt-------%%%--y---y------tt-tt%%%-%%
XXXXX----XXXXXXXXXXXXXX----XXXXXXXXXXX--XXXXXXXXXX--XXXXXXXXXX--XXXXXXXXXXXXXXXXXXXXXXXXXXXXX----X-XXXXXXX--XXXXXXXX---XXX-XXXX----XXXXXXXXXXXXXXXXXXX
XXXXX----XXXXXXXXXXXXXX----XXXXXXXXXXX--XXXXXXXXXX--XXXXXXXXXX--XXXXXXXXXXXXXXXXXXXXXXXXXXXXX----X-XXXXXXX--XXXXXXXX---XXX-XXXX----XXXXXXXXXXXXXXXXXXX
