------------------------------------------------------------------------------------------------------------------------------------------------------
------------------------------------------------------------------------------------------------------------------------------------------------------
------------------------------------------------------------------------------------------------------------------------------------------------------
------------------------------------------------------------------------------------------------------------------------------------------------------
----------------------------------------------------------------------------------SSSSS---@@@@@-------------------------------------------------------
------------------------------------------------------------------------------------------------------------------------------------------------------
------------------------------------------------------------------------------------------------------------------------------------------------------
----------------------------------oooo----------------------------------------------------------------------------------------------------------------
---CCCCC-----!!-------------------oooo----------------------------------oooo--------------------------------------------------------------------------
ooo----------------------------y--------k-------------------------------oooo------------------------------------oo-----------ooS--------------------k-
-----------------------------tt-----------tt----------------------------oooo--------TT----tt-----r-------oo--r--oo-----------oo---k----k------------tt
------------------k----------tt-----------tt----------------%%%%------------------ttTT----tt%%%%------------%%%-----------------tt%--%%%------------tt
-------------tttt------------tt----%%-----tt--------------%%%%%%------------------ttTT----tt%%%%----SSSSS---%%%-----------tt----tt%--%%%------------tt
M---------r--tttt------g---g-tt----%%-----tt--------------%%%%%%----------------r-ttTT----tt%%%%------------%%%----g------tt----tt%--%%%----r---k---tt
XXXXXXXXXXXXXXXXXXXXXXX------XXXXXXXX-----XX---XXXXX---XXXXXXXXX--------XXXXXXX---XXXX----XXXXXX----XXXXXXXXXXXXXXXXXXXXXXXXXXXXXXX--XXX--------XXXXXX
XXXXXXXXXXXXXXXXXXXXXXX------XXXXXXXX-----XX---XXXXX---XXXXXXXXX--------XXXXXXX---XXXX----XXXXXX----XXXXXXXXXXXXXXXXXXXXXXXXXXXXXXX--XXX--------XXXXXX
