------------------------------------------------------------------------------------------------------------------------------------------------------
------------------------------------------------------------------------------------------------------------------------------------------------------
------------------------------------------------------------------------------------------------------------------------------------------------------
------------------------------------------------------------------------------------------------------------------------------------------------------
------------------------------------------------------------------------------------------------------------------------------------------------------
------------------------------------------------------------------------------------------------------------------------------------------------------
------------------------------------------------------------------------------------------------------------------------------------------------------
--------------------------LLLL-------------------------------------------------------------------------------------------@oo--------------------------
---------------oooo-----------------------------------------------------------ooooo---------------------SS----------------oo--------------------------
---------------oooo--SSSS-------------------o---------------------------------ooooo------------------------------LLLS-----oo!!!!U---------------------
-------------@-oooo---------------------tt----r-%%%----------------tt--------------------------CCC----------------------------------------------------
---------oooo-Utt--@@----C--ttoooo----tttt----tt%%%----------------tt-----------tt-SS-----------------SS------tt--------tt----------@@@@------------oo
-k-------oooo--tt-----------tt--------tttttt%%tt%%%------S---------tttt---tt----tt----------------LLLL---tt---tt--------tttttttt--------------------oo
M--------oooo--tt---------%%tt--------tttttt%%tt%%%%%%%%-----------tttt---tt----tt%%-----k---------------tt---tt--------tttttttt--r------k--------g---
XXXXXXX--------XXXXXXXXXXXXXXXXXXXXXXXXXXXXXXXXXXXXXXXXX---XXXXXXXXXXXX---XX----XXXXXXXXXXXXXX----XXXXXXXXX---XXXXXXXXXXXXXXXXXX----XXXXXXXXXXXXXXXXXX
XXXXXXX--------XXXXXXXXXXXXXXXXXXXXXXXXXXXXXXXXXXXXXXXXX---XXXXXXXXXXXX---XX----XXXXXXXXXXXXXX----XXXXXXXXX---XXXXXXXXXXXXXXXXXX----XXXXXXXXXXXXXXXXXX
