------------------------------------------------------------------------------------------------------------------------------------------------------
------------------------------------------------------------------------------------------------------------------------------------------------------
------------------------------------------------------------------------------------------------------------------------------------------------------
------------------------------------------------------------------------------------------------------------------------------------------------------
------------------------------------------------------------------------------------------------------------------------------------------------------
------------------------------------------------------------------------------------------------------------------------------------------------------
------@@@---------------------------------------------------------------------------------------------------------------------------------------------
------------------oo--------------------------o------------------------------------------!!!!---------------------------------------------------------
------------------oo----------------------!!!!oSSS------------------------ooo-------------------------------------------------------------------------
-----------g-----------------------g----r-----o----------r----------------ooo--------------------------------------------------------------y----oooo--
--oooo%%--%--------------------@@---%%%----------------tttt-----ooooo-----ooo--------%%%--------@@@@----------------------tt------------%%%---C-oooo--
--oooo%%--%----g---%%%%--%%-------tt%%%-----tt----CCCCCtttt-----ooooo-----%%%----%%%%%%%----------------------------------tt-----oo-----%%%-----------
------%%tt%------tt%%%%--%%-------tt%%%%%%tttttt-------tttt-----ooooo---%%%%%%%%%%%%%%%%----------------------------------tt-------S----%%%----o------
M-----%%tt%------tt%%%%--%%--r----tt%%%%%%tttttt-------tttt%%%----------%%%%%%%%%%%%%%%%%%%%--g--------------k------------tt---k--------%%%%---o-----k
------XXXXXXXXXXXXXXXXX--XX-XXXXXXXXXXXXXXXXXXXXXXX----XXXXXXXXXXXXXXX--XXXXXXXXXXXXXXXXXXXXXXXXXXXXXXXXXXX-----XXXXXXXXXXXX----XXXXXXXXXXXXXXXX------
------XXXXXXXXXXXXXXXXX--XX-XXXXXXXXXXXXXXXXXXXXXXX----XXXXXXXXXXXXXXX--XXXXXXXXXXXXXXXXXXXXXXXXXXXXXXXXXXX-----XXXXXXXXXXXX----XXXXXXXXXXXXXXXX------
