------------------------------------------------------------------------------------------------------------------------------------------------------
------------------------------------------------------------------------------------------------------------------------------------------------------
------------------------------------------------------------------------------------------------------------------------------------------------------
------------------------------------------------------------------------------------------------------------------------------------------------------
------------------------------------------------------------------------------------------------------------------------------------------------------
--------------------------------------------------------------@@@-------------------------------------------------------------------------------------
--------------------------------------CCC-----------------------------------------------------U-------------------------------------------------------
------------------------------------------------------------------------------------------------------------------------------------------------------
-------------!!!-----oo------------------------------------------------------------------------------------LLL----------------------------------------
------------------------------------oo-----------SSSS--y---k---------------oooLLL-------------------------o-------------------------------------------
----------------------%%%tttt----r--oo-----------------%----%%%-------------------------------------o-----o-----------%-----------g-------%%-------ooo
------------------r---%%%tttt---tttt-----------------TT%----%%%-------ooooo-------r--------g--------o-----%%%%SSS-----%------ooo-tt-UUUUtt%%----------
tt%-----------------tt%%%tttt---tttt%%%%-------------TT%----%%%-------ooooo-%%----tt-----%---tt-----o-----%%%%--------%----%%%%--tt-----tt%%----------
tt%--------r--------tt%%%tttt---tttt%%%%---r---k-----TT%----%%%-------------%%----tt--y--%---tt--r---ooooo%%%%----r---%----%%%%--tt-----tt%%-----g----
XXX-XXXXXXXXXXXXX---XXXXXXXXX---XXXXXXXXXXX--XXXXXXXXXXXXXXXXXXXXXXXXXXX----XX----XX-----X---XXXXX--XXXXXXXXXXXXXXX---XXXXXXXXX--XXXXXXXXXXXXXXXX---XX
XXX-XXXXXXXXXXXXX---XXXXXXXXX---XXXXXXXXXXX--XXXXXXXXXXXXXXXXXXXXXXXXXXX----XX----XX-----X---XXXXX--XXXXXXXXXXXXXXX---XXXXXXXXX--XXXXXXXXXXXXXXXX---XX
