------------------------------------------------------------------------------------------------------------------------------------------------------
------------------------------------------------------------------------------------------------------------------------------------------------------
------------------------------------------------------------------------------------------------------------------------------------------------------
------------------------------------------------------------------------------------------------------------------------------------------------------
------------------------------------------------------------------------------------------------------------------------------------------------------
------------------------------------------------------------------------------------------------------------------------------------------------------
-----------------------------------SSSS-------------------------------------------------------------------------------------------------SS------------
------------------------------------------------------------------------------------------------------------------------------------------------------
-------------UUUUU-------------------------------------------LLL---------------------------------ooooo------------------------------------------------
-----y---------------------------------ooo-------------------------------ooooo--------r----------ooooo---------LLL------SS--g-------------------------
-----tt--------------------------r-----ooo--%%---------------------------oooooUUUU-----%%%------------------%----------------tt------tttt-------------
----%tt---TT---------------ooooo%----%%%----%%-ooo---------oo-----------%ooooo---------%%%------%%%%------tt%tt---!!!!!-%%---tt--tt--tttt-------------
-g--%tt---TTo--------------ooooo%----%%%----%%-ooo----------------------%TT--------r---%%%------%%%%--!!!-tt%tt---------%%---tttttttttttt-------------
M---%tt%%%TT--%%%%--------------%----%%%----%%-----------r-------y---%%%%TT---------%%%%%%------%%%%------tt%tt--------o%%---tttttttttttt------------g
----XXXXXXXX--XXXXXXXXXXXXXXXXXXX----XXX----XXXXXXXXXXXXXXXXXXXXXXXXXXXXXXXXXXXXXXXXXXXXXX------XXXX------XXXXX--XXXXXXXXXXXXXXXXXXXXXXXXXXXXXXXXXXXXX
----XXXXXXXX--XXXXXXXXXXXXXXXXXXX----XXX----XXXXXXXXXXXXXXXXXXXXXXXXXXXXXXXXXXXXXXXXXXXXXX------XXXX------XXXXX--XXXXXXXXXXXXXXXXXXXXXXXXXXXXXXXXXXXXX
