------------------------------------------------------------------------------------------------------------------------------------------------------
------------------------------------------------------------------------------------------------------------------------------------------------------
------------------------------------------------------------------------------------------------------------------------------------------------------
------------------------------------------------------------------------------------------------------------------------------------------------------
------------------------------------------------------------------------------------------------------SS----------------------------------------------
-----SSSSS--------------------------------------------------------------------------------UUUU--------------------------------------------------------
----------------------------------------------------------------------------------------------------------------------------------------------------@@
------------------------------------------------------------------------------@@----------------------------------------------------------------------
----------ooooo-------------------------------------------------------!!!!-------------------------------------o--------------------------------------
@@@@@-----ooooo----y--LLL-----------------------------------ooooo-----------g--------------------ooooo---------o------------k-ooooo-----------g-------
--------%%%--------tt-----------------------------------ooooooooo-----------tt%%!!!!---tt-----ooo----tt--------o-----oo-y--tt-ooooo----------tt----tt-
----tt--%%%--------tt-------ooo---------------------------------------------tt%%-------tt-%%%%%%%----tt--------------oo-%%%tt----------------tt----tt-
----tt--%%%--------tt-------ooo-------ooo@@@---------------tt---------------tt%%-------tt-%%%%%%%%---tt-----------------%%%tt----------------tt----tt-
M---tt--%%%--------tt-----y-----------ooo----k----------%%%tt---------------tt%%%%-----tt-%%%%%%%%---tt---r--------r----%%%tt--------y-----%-tt----tt-
----XX--XXXXXXXXXXXXX----XXXXX-XXXXXXXXXXXX-------------XXXXXXXXXXXXXXXXXXXXXXXXXX-----XX-XXXXXXXXXXXXX----XXXXXXXXX-XXXXXXXXXXXXXXXX------X-XX----XX-
----XX--XXXXXXXXXXXXX----XXXXX-XXXXXXXXXXXX-------------XXXXXXXXXXXXXXXXXXXXXXXXXX-----XX-XXXXXXXXXXXXX----XXXXXXXXX-XXXXXXXXXXXXXXXX------X-XX----XX-
