------------------------------------------------------------------------------------------------------------------------------------------------------
------------------------------------------------------------------------------------------------------------------------------------------------------
------------------------------------------------------------------------------------------------------------------------------------------------------
------------------------------------------------------------------------------------------------------------------------------------------------------
------------------------------------------------------------------------------------------------------@@@@@-------------------------------------------
------------------------------------------------------------------------------------------------------------------------------------------------------
---------------------------------------------------------------UUUU-------------------------------------------------------@@@@@-----------------------
-----------------------------------------------------------------------------------------o------------------------------------------------------------
--------------ooooo-------------------------------------LLLoooo------------------------oo----------ooo------------------------------------------------
--------------oooooooo------------------r-UUU--------------oooo------r----------------------r------ooo------------------------------------------------
--------------tt%%-ooo------------------tt-----------------------TT--tt----------------tt%%%-------ooo---%--------------k-----------------------------
--------------tt%%-ooo------------------tt-----------------------TTtttt-----------ooooott%%%%%-----------%----tt--------tttt----k---k--r-----tt-------
--------tt----tt%%-------@@@%%----------tt---oooSSoo---------%%%%TTtttt------tt---ooooott%%%%%-----------%----tt------tttttt%%%%----TT%%%----tt-------
M-------tt----tt%%-----g----%%---------%tt---ooo--oo--k------%%%%TTtttt------tt--------tt%%%%%---y-------%----tt------tttttt%%%%----TT%%%----tt-------
XXXXXXXXXX----XXXX----XXX---XX---XXXXXXXXXXXXXXXX---XXXXXXXXXXXXXXXXXXXXXXXXXXXXXXXXXXXXXXXXXX----XXXXXXXX----XXXXXXXXXXXXXXXXXXXXXXXXXXX----XXXXXXXXX
XXXXXXXXXX----XXXX----XXX---XX---XXXXXXXXXXXXXXXX---XXXXXXXXXXXXXXXXXXXXXXXXXXXXXXXXXXXXXXXXXX----XXXXXXXX----XXXXXXXXXXXXXXXXXXXXXXXXXXX----XXXXXXXXX
