------------------------------------------------------------------------------------------------------------------------------------------------------
------------------------------------------------------------------------------------------------------------------------------------------------------
------------------------------------------------------------------------------------------------------------------------------------------------------
------------------------------------------------------------------------------------------------------------------------------------------------------
------------------------------------SSSSS-------------------------------------------------------------------------------------------------------------
--------@@@@----------------------------------------------------------------SS------------------------------------------------------------------------
------------------------------------------------------------------------------------------------!@@@----------------------------------------------UUUU
------------------------------------------------------------------------------------------------------------------------------------------------------
---------------------------!!-------------------------------------------------------------------------------------------------------------------------
----------------------!!---------!!!--------------g--------------g----k----------------------------------oooo---UUU-r---------------------------------
------------------------@@@tt-------tt---ooooo!!-tt------------%%%tt%%----k--------oooo--tt--------------ooooooo---%%%---------%----tt--%-------------
----------tt----------tt---tt-------tt----tt-----tt------------%%%tt%%----%%%------------tt---TTtt--SSS------ooo---%%%---------%----tt--%-------------
----------tt--------oott---tt-------tt----tt-----tt-----------U%%%tt%%%%%%%%%---r--------tt---TTtt-----!!----ooo---%%%---------%----tt--%------------%
M---------tt--------oott---tt--g----tt----tt-----tt------------%%%tt%%%%%%%%%----%%%-----tt---TTtt-----------------%%%--r------%---%tt--%------------%
XXX--XXXXXXXXXXXXXXXXXXX---XXXXXXXXXXX----XXXXX--XX----XXXXXXXXXXXXXXXXXXXXXX----XXXXXXXXXX---XXXXXXXXXXXXXXXXXXXXXXXX---XXXXXXX---XXX--XXXXXXXXXXXXXX
XXX--XXXXXXXXXXXXXXXXXXX---XXXXXXXXXXX----XXXXX--XX----XXXXXXXXXXXXXXXXXXXXXX----XXXXXXXXXX---XXXXXXXXXXXXXXXXXXXXXXXX---XXXXXXX---XXX--XXXXXXXXXXXXXX
