------------------------------------------------------------------------------------------------------------------------------------------------------
------------------------------------------------------------------------------------------------------------------------------------------------------
------------------------------------------------------------------------------------------------------------------------------------------------------
------------------------------------------------------------------------------------------------------------------------------------------------------
------------------------------------------------------------------------------------------------------------------------------------------------------
---------------o--------------------------------------------------------------------------------------------------------------------------------------
---------------o------------------------------------------------------------------------------------UU------------------------------------------------
-------------------------------------------------------------------ooo-----------------------------------------!!-------------------------------------
----------SSSSS-!----ooooo---------------------------ooooo--------------------------------ooooo-------SSSS--------------------------------------------
-----------------------------------------------------ooooo--------------------------------ooooo--y----------------------------------------------------
-------------%%%------%%%%-------------------------------------------tt-------oo--g----y--ooooo----TTtt-----------r------------------y----------------
-----------tt%%%---y--%%%%----%%-----------------------------------tttt-----y------%%%-------------TTtt-----------tt-----------oooo----TT-%%-----%%---
---------tttt%%%tt--tt%%%%----%%---%-------%%%%tt-----------------Utttt---%--------%%%-------------TTtt--%--------tt%%---------oooo----TT-%%-----%%tt-
M--------tttt%%%tt--tt%%%%--g-%%---%---g---%%%%tt-------%------g---tttt---%-----%%%%%%-------------TTtt--%----%%%%tt%%-----------------TT%%%-----%%ttk
---XXXXXXXXXXXXXXX--XXXXXX----XXXXXX---XXXXXXXXXXXXXXXXXX----XXXXXXXXXX---X-----XXXXXXXXXXXXXXXXXXXXXXX--X----XXXXXXXXXXXXXX------XXXXXXXXXXXXXXXXXXX-
---XXXXXXXXXXXXXXX--XXXXXX----XXXXXX---XXXXXXXXXXXXXXXXXX----XXXXXXXXXX---X-----XXXXXXXXXXXXXXXXXXXXXXX--X----XXXXXXXXXXXXXX------XXXXXXXXXXXXXXXXXXX-
