------------------------------------------------------------------------------------------------------------------------------------------------------
------------------------------------------------------------------------------------------------------------------------------------------------------
------------------------------------------------------------------------------------------------------------------------------------------------------
------------------------------------------------------------------------------------------------------------------------------------------------------
--------------------------------------------------------ooooooooo-------------------------------------------------------------------------------------
--------------------------------------------------------ooooooooo-----------------------------------------CCCCC---------------------------------------
-------------------------------------@@@@@@@@@@---------ooooooooo-------------------------------------------------------------------------------------
--------------SSS--------------------------------------------------------------------------------------------------------------ooo--------------------
----------ooo----------------------------------------------------------------ooooo-------------ooo---------------------ooooo---ooo--------------------
----U-----------------SSSSSSS----r--------------y-----------------!!!!!------ooooo--------------------r------------------------ooo------k-S-----------
-----------------------------TT----------------ttUU------TT---------------g-------------k--------tt--------tt--------y-----------------TT------g----y-
-------k-----------r---------TT------tt--------tt--------TT-----------------%%%tt------tt--------tt--------tt-------%%%%---------------TT-----%%%---tt
--r------tt-----tt-------%%%%TT------tt--------tt--------TT-----------------%%%tt------tt--LLLL--tt--------tt----r--%%%%--------TT-----TT-----%%%---tt
M-%%%%---tt--r--tt-------%%%%TT------tt%%%%----tt----r---TT------g-----g----%%%tt---k--tt--------tt--------tt----%--%%%%-----y--TT--k--TT--%%-%%%---tt
XXXXXXXX-XXXXXXXXXXXXX--XXXXXXXXXXXXXXXXXXXXXXXXXXXXXXX--XX--XXXXXX--XXXXXXXXXXXXXXXXXXXXXXXXXXXXXXXXXXXXXXXXXXXXXXXXXXX-XXXXXXXXXXXXXXXXXXXXXXXXXXXXX
XXXXXXXX-XXXXXXXXXXXXX--XXXXXXXXXXXXXXXXXXXXXXXXXXXXXXX--XX--XXXXXX--XXXXXXXXXXXXXXXXXXXXXXXXXXXXXXXXXXXXXXXXXXXXXXXXXXX-XXXXXXXXXXXXXXXXXXXXXXXXXXXXX
