M-----------------------------------------------------------------------------------------------------------------------------------------------------
------------------------------------------------------------------------------------------------------------------------------------------------------
------------------------------------------------------------------------------------------------------------------------------------------------------
-------------------------------------------------------------------------------------------------------k----------------------------------------------
---------------------------------------------------------oo----------------------------ooo-----------g-----k------------------------------------------
-------------------------------------------------------o-oo------------------o---------ooo----------LL---g-------------------------L------------------
----------------o--------------------LL----------------o---------------------------LL--------------------L---------------------------------oo---------
----------------o--------------------------------ooo---o-------------------k---k----------k------o---------------------L---o-o--ooo------------LL-----
-----------------LLL-----------------------L-----ooo-----k----------LL---g---g----------g--------o-----------o-------------g-o--oook----------k-------
---------------g---------------------------------ooo---g--tt------------tt--tt----Ltt-XXXXXL--------tt--tt---o----tt------tt-----g---XXXXX--g------o--
--------------XXX----------tt--------tt-XXX-g-tt------tt--tt----XXXX----tt--tt-----tt-XXXXX------kg-tt--tt---o----tt--tt--tt----tt---XXXXX-tt------o--
--------------XXXXXXX------tt--------tt-XXXXX-tt------tt--tt----XXXX----tt--tt--*--tt-XXXXX-g--g-XX-tt--tt--g-----tt--tt--tt----tt---XXXXX-tt-XXXX----
XXXXX----XXXXXXXXXXXXXXXXXXXXX--XXXXXXXXXXXXXXXXXXXXXXXXXXXXX---XXXXXXXXXXXXXXXXXXXXXXXXXXXXXXXXXXXXXXXXXXXXXX---XXXXXXXXXXXXXXXXXXXXXXXXXXXXXXXXXXXXX
XXXXX----XXXXXXXXXXXXXXXXXXXXX--XXXXXXXXXXXXXXXXXXXXXXXXXXXXX---XXXXXXXXXXXXXXXXXXXXXXXXXXXXXXXXXXXXXXXXXXXXXX---XXXXXXXXXXXXXXXXXXXXXXXXXXXXXXXXXXXXX
XXXXX----XXXXXXXXXXXXXXXXXXXXX--XXXXXXXXXXXXXXXXXXXXXXXXXXXXX---XXXXXXXXXXXXXXXXXXXXXXXXXXXXXXXXXXXXXXXXXXXXXX---XXXXXXXXXXXXXXXXXXXXXXXXXXXXXXXXXXXXX
XXXXX----XXXXXXXXXXXXXXXXXXXXX--XXXXXXXXXXXXXXXXXXXXXXXXXXXXX---XXXXXXXXXXXXXXXXXXXXXXXXXXXXXXXXXXXXXXXXXXXXXX---XXXXXXXXXXXXXXXXXXXXXXXXXXXXXXXXXXXXX
