M-----------------------------------------------------------------------------------------------------------------------------------------------------
------------------------------------------------------------------------------------------------------------------------------------------------------
------------------------------------------------------------------------------------------------------------------------------------------------------
---------------------------------------------------------------------------------o--------------------------------------------------------------------
---------------------------------------------------------------------------------o---------------------------------------------------o----------------
--------------------------------------------oo------------------------LL---------o---------------------------------------------------o--L---o---------
--oo----------------------------------------oo---------------LL---------------LL-----------------------------------------------------o------o---------
--oo-------o--------------------------------oo----------------------------------------------------k-----LL-----k---------k---------------L------------
--oo-------o-----------------------LL------------------LL-------------------------g------o------g--oo--------g------o--g----------------k---g---------
-----tt----g-----------o-------LLL---------XXX------*-----------XXXXX-tt------tt-XXo-----o-----tt--oo-------TT------oXXXX----tt-------g----XXX-------L
-tt--tt---XX--------------------------XXXXXXXX------*--------tt-XXXXX-tt------tt-XX--XXXX------tt-----------TT-------XXXX----tt-----ktt-XXXXXX-oooo---
-tt--tt---XX--------------------------XXXXXXXX---*--*--------tt-XXXXX-tt-XXXX-tt-XX--XXXX---*--tt-----*-XXX-TT------gXXXX----tt---g--tt-XXXXXX-----XX-
XXXXXXXX--XX--XXXXX---XXXX--XXXXXXXXXXXXXXXXXX--XXXXXX-XXXXXXXXXXXXXXXXXXXXXXXXXXXXXXXXXXXXXXXXXXXXXXXXXXXXXXXXXXXXXXXXXX---XXXXXXXXXXXXXXXXXXXXXXXXXX
XXXXXXXX--XX--XXXXX---XXXX--XXXXXXXXXXXXXXXXXX--XXXXXX-XXXXXXXXXXXXXXXXXXXXXXXXXXXXXXXXXXXXXXXXXXXXXXXXXXXXXXXXXXXXXXXXXX---XXXXXXXXXXXXXXXXXXXXXXXXXX
XXXXXXXX--XX--XXXXX---XXXX--XXXXXXXXXXXXXXXXXX--XXXXXX-XXXXXXXXXXXXXXXXXXXXXXXXXXXXXXXXXXXXXXXXXXXXXXXXXXXXXXXXXXXXXXXXXX---XXXXXXXXXXXXXXXXXXXXXXXXXX
XXXXXXXX--XX--XXXXX---XXXX--XXXXXXXXXXXXXXXXXX--XXXXXX-XXXXXXXXXXXXXXXXXXXXXXXXXXXXXXXXXXXXXXXXXXXXXXXXXXXXXXXXXXXXXXXXXX---XXXXXXXXXXXXXXXXXXXXXXXXXX
