M-----------------------------------------------------------------------------------------------------------------------------------------------------
------------------------------------------------------------------------------------------------------------------------------------------------------
------------------------------------------------------------------------------------------------------------------------------------------------------
-----------------------------------------------------------------------------------------------------------------------------------------L------------
----------------------------------------------o-----------------------------------------L-oo--------------------------------------oo--------ooo-------
----------------------------------------------o----g-----------oooooo---oo-----g----------oo--------------------------------------oo--------ooo-------
--------------------L-------------------------o---LL---------o-ooo------oo-----L----------oo-------------------------------------koo--------ooo-------
------------o-------------k---------------------o------ooo---o-ooo------oo-----------------------------------------------------g---------k------------
------------o-----------g-----------------------o------oook---k-----------------------ook------------------------L---oo-------LL-------g-------k------
-g----------o-------XX-LL--tt--*----------o---g-o-XXX---g---g------tt---------XXXXXX--g----tt--TT---------*--LL------oo---ooo-----tt--tt-----g--------
XX-------------XX-*-XX-----tt--*-------------tt---XXX--tt-XXXX-tt--tt--tt-XXXXXXXXXX-tt----tt--TT--tt-----*------------k----------tt--tt----tt--------
XX-----------g-XX-*-XX-----tt--*--g----------tt--gXXX--tt-XXXX-tt--tt--tt-XXXXXXXXXX-tt----tt--TT--tt--*--*----------g------------tt--tt----tt-------g
XXXXXXXXXXXXXXXXXXXXXXXXXXXXXXXXXXXX--XXXXXXXXXXXXXXX-XXXXXXXXXXXXXXXXXXXXXXXXXXXXXXXXXXXXXXXXXXXXXXXXXXXXXXXXXXXXXXXXXXXXXXXXXXXXXXXXXXXXXXXXXXXXXXXX
XXXXXXXXXXXXXXXXXXXXXXXXXXXXXXXXXXXX--XXXXXXXXXXXXXXX-XXXXXXXXXXXXXXXXXXXXXXXXXXXXXXXXXXXXXXXXXXXXXXXXXXXXXXXXXXXXXXXXXXXXXXXXXXXXXXXXXXXXXXXXXXXXXXXX
XXXXXXXXXXXXXXXXXXXXXXXXXXXXXXXXXXXX--XXXXXXXXXXXXXXX-XXXXXXXXXXXXXXXXXXXXXXXXXXXXXXXXXXXXXXXXXXXXXXXXXXXXXXXXXXXXXXXXXXXXXXXXXXXXXXXXXXXXXXXXXXXXXXXX
XXXXXXXXXXXXXXXXXXXXXXXXXXXXXXXXXXXX--XXXXXXXXXXXXXXX-XXXXXXXXXXXXXXXXXXXXXXXXXXXXXXXXXXXXXXXXXXXXXXXXXXXXXXXXXXXXXXXXXXXXXXXXXXXXXXXXXXXXXXXXXXXXXXXX
