M-----------------------------------------------------------------------------------------------------------------------------------------------------
------------------------------------------------------------------------------------------------------------------------------------------------------
------------------------------------------------------------------------------------------------------------------------------------------------------
--------------------------------------------------------------------------------------------------------------------------------------------L---------
------------------------------------------------------------------------------------------------------------------------------------------------------
------------L----------------------------------------------------------------------------------------------------------------L---------------L--------
--------------------------------------LL-----------------------oo-----------------------------------------------o-------------------------------------
--------oo---L------k-------------------------------LL---------oo-----------------------------------------------o---------L-----------oo----k---------
------g-oo--k-----g-----g--------LL---------------------LL-----oo----------L-ooo--------------------------------o-----------L---L--g--oo--g-----------
----XXXX--g------tt----XX-*---------L-XXX---tt-XXXXL--------------------LL---ooo--o------------L------------------*----------tt---LL----XXXX-tt--tt--L
-tt-XXXX-tt--tt--tt----XX-*--*--------XXX---tt-XXXX-TT-------*--tt--------------------tt--*----------k-------k----*----------tt---------XXXX-tt--tt---
-tt-XXXX-tt--tt--tt----XX-*--*--------XXX---tt-XXXX-TT-------*--tt-----------------g--tt--*--------g-------g------*----XXXXX-tt-------g-XXXX-tt--tt---
XXXXXXXXXXXXXXXXXXXX---XXXXXXXX--XXXXXXXX--XXXXXXXXXXXXXXXXXXXXXXXX-XXX-XXXXXXXXXXXXXXXXXXXXXXXXXXXXXX---XXXXXXXXXXXXX-XXXXXXXXXXXXXXXXXXXXXXXXXXXXXXX
XXXXXXXXXXXXXXXXXXXX---XXXXXXXX--XXXXXXXX--XXXXXXXXXXXXXXXXXXXXXXXX-XXX-XXXXXXXXXXXXXXXXXXXXXXXXXXXXXX---XXXXXXXXXXXXX-XXXXXXXXXXXXXXXXXXXXXXXXXXXXXXX
XXXXXXXXXXXXXXXXXXXX---XXXXXXXX--XXXXXXXX--XXXXXXXXXXXXXXXXXXXXXXXX-XXX-XXXXXXXXXXXXXXXXXXXXXXXXXXXXXX---XXXXXXXXXXXXX-XXXXXXXXXXXXXXXXXXXXXXXXXXXXXXX
XXXXXXXXXXXXXXXXXXXX---XXXXXXXX--XXXXXXXX--XXXXXXXXXXXXXXXXXXXXXXXX-XXX-XXXXXXXXXXXXXXXXXXXXXXXXXXXXXX---XXXXXXXXXXXXX-XXXXXXXXXXXXXXXXXXXXXXXXXXXXXXX
