M-----------------------------------------------------------------------------------------------------------------------------------------------------
------------------------------------------------------------------------------------------------------------------------------------------------------
------------------------------------------------------------------------------------------------------------------------------------------------------
------------------------------------------------------------------------------------------------------------------------------------------------------
-------------------g---------------------------------------------k----------------------k-------------------------------------------------------------
-------------------L-------------------------------------------g----------oo----------g---------------------------------------------------------------
------------------------L----ooo-------------------------k-L--LL----------oo---------LL--LL---oo------ooo------------------------LL------------L------
-----------------------------ooo-----------------------g------------------oo------------------oo------oook--ooo----------------------g---------------k
--LL-------------------------ooo----------------------LL----------L------o----k--oo-L---------g--------g----ooo-o---------g----------L-------------g--
------------------XXX-------------XXX--------------*---------------------o--g----oo-----XXXXXXXX------tt---------------ooXXX-----tt-----------XXXXXXXX
------------------XXX--XXX---XXXXXXXX--------------*------tt--tt----------XXXX-------tt-XXXXXXXX------tt-----tt--g-g---ooXXX-o--ktt--------tt-XXXXXXXX
---------g--------XXX-gXXX--gXXXXXXXX-g---------*--*------tt--tt----XXXX-gXXXX-*--g--tt-XXXXXXXX------tt--g--tt-XXXXX--g-XXX--g--tt--------tt-XXXXXXXX
XXXXX---XXXXXXXXXXXXXXXXXX-XXXXXXXXXXXXXXX-XXX-XXXXXXXXXXXXXXXXXXXXXXXXXXXXXXXXXXXXXXXXXXXXXXXXX--XXXXXXXXXXXXXXXXXXXXXXXXXXXXXXXXXXXXXXXXXXXXXXXXXXXX
XXXXX---XXXXXXXXXXXXXXXXXX-XXXXXXXXXXXXXXX-XXX-XXXXXXXXXXXXXXXXXXXXXXXXXXXXXXXXXXXXXXXXXXXXXXXXX--XXXXXXXXXXXXXXXXXXXXXXXXXXXXXXXXXXXXXXXXXXXXXXXXXXXX
XXXXX---XXXXXXXXXXXXXXXXXX-XXXXXXXXXXXXXXX-XXX-XXXXXXXXXXXXXXXXXXXXXXXXXXXXXXXXXXXXXXXXXXXXXXXXX--XXXXXXXXXXXXXXXXXXXXXXXXXXXXXXXXXXXXXXXXXXXXXXXXXXXX
XXXXX---XXXXXXXXXXXXXXXXXX-XXXXXXXXXXXXXXX-XXX-XXXXXXXXXXXXXXXXXXXXXXXXXXXXXXXXXXXXXXXXXXXXXXXXX--XXXXXXXXXXXXXXXXXXXXXXXXXXXXXXXXXXXXXXXXXXXXXXXXXXXX
