M-----------------------------------------------------------------------------------------------------------------------------------------------------
------------------------------------------------------------------------------------------------------------------------------------------------------
------------------------------------------------------------------------------------------------------------------------------------------------------
---------------------------------------------------------------------------------------------------------------------------------------g--------------
---------------------------------------------------------------------------------oo----------------------------------------------------o--------------
----------------------------------------------------------------------g----------oo----------------------------------------------------o------------g-
---------------------------------------------------------------------CC----------oo--------------------oo------------------------------o-----------oo-
-L----g--------------------k--g--g-------o------------------------------oooo----o------------LL--------oo---------------------------g--------------oo-
------o-------------------g--!!-oo-------k-------------g---g-LL---------oooo--SSo----------------------oo--o--------------g--------oo--------------oo-
------o---g----------@@@XXXXX---oo------go----o-------oo-XXXX--------ttCoooo----ott------------XX--oo--TToXXX---k---------o--------oo-XXX---------XXXX
---o--o--tt--g-o--------XXXXX---------XXXXX---o---oo--oo-XXXX------o-tt----------tt---XX----XXXXX------TToXXX--g---tt-----------XXX---XXX----XXXXXXXXX
XX-oXXXX-tt-XX--g--g----XXXXX---------XXXXX---o-g--------XXXX-----g--tt-XXXXX-XX-tt---XX--g-XXXXX------TToXXXXXXXX-tt-----------XXXXXXXXX-XXXXXXXXXXXX
XXXXXXXXXXXXXXXXXXXXXXXXXXXXXXXXXXXXXXXXXXX---XXXXXXXXXXXXXXXXXXXXXXXXXXXXXXX-XXXXXX--XXXXXXXXXXXXXXXXXXXXXXXXXXXXXXXX---XXXXX--XXXXXXXXX-XXXXXXXXXXXX
XXXXXXXXXXXXXXXXXXXXXXXXXXXXXXXXXXXXXXXXXXX---XXXXXXXXXXXXXXXXXXXXXXXXXXXXXXX-XXXXXX--XXXXXXXXXXXXXXXXXXXXXXXXXXXXXXXX---XXXXX--XXXXXXXXX-XXXXXXXXXXXX
XXXXXXXXXXXXXXXXXXXXXXXXXXXXXXXXXXXXXXXXXXX---XXXXXXXXXXXXXXXXXXXXXXXXXXXXXXX-XXXXXX--XXXXXXXXXXXXXXXXXXXXXXXXXXXXXXXX---XXXXX--XXXXXXXXX-XXXXXXXXXXXX
XXXXXXXXXXXXXXXXXXXXXXXXXXXXXXXXXXXXXXXXXXX---XXXXXXXXXXXXXXXXXXXXXXXXXXXXXXX-XXXXXX--XXXXXXXXXXXXXXXXXXXXXXXXXXXXXXXX---XXXXX--XXXXXXXXX-XXXXXXXXXXXX
