M-----------------------------------------------------------------------------------------------------------------------------------------------------
----------------------------------------------------------------------------------L-------------------------------------------------------------------
------------------------------------------------------------------------------------------------------------------------------------------------------
------------------------------------------------------------------------------------------------------------------------------------------------------
----------------k-------------------------------------------------------------------------------------------------------------------------------------
-----L--------g------------------LL-----------------------------------------------k----------------------------------------------------------------LL-
ooo-L----oo---L-------------------------LL----------oo-----------L-----oo----o--g------------------------k--------------------------------------------
ooo------oo---------------------------------------k--------------------oo------LL----------------------g---------------------o------------L-----------
ooo---------------------------------------------g----------------------oo------------------------L----LL-o-------LL-------------------------------L---
-----tt-XXX--TT---------L--------tt------------tt--tt------tt--*-XX-L-------XX---------o----*-L----------o---*---------LL-----g--tt----------*-----tt-
----ktt-XXX--TT--tt--------g-----tt-XXXXXXX----tt--tt-----ktt--*-XX---------XX-tt-----------*------------o---*---------------XXX-tt------XXX-*-----tt-
--g--tt-XXX--TT--tt-------XXX----tt-XXXXXXX--g-tt--tt---g--tt--*-XX---------XX-tt------XX---*-------g--------*------XX-----g-XXX-tt------XXX-*-----tt-
XXXXXXXXXXX-XXXXXXXX-XXXXXXXXXXXXXXXXXXXXXX-XXXXXXXXXXXXXXXXXXXXXXXXXXXXXXXXXXXXXXXX---XX--XXXXXXXXXXXXXXXXXXXXXXXXXXXXXXXXXXXXXXXXXXXXXXXXXXXX--XXXXX
XXXXXXXXXXX-XXXXXXXX-XXXXXXXXXXXXXXXXXXXXXX-XXXXXXXXXXXXXXXXXXXXXXXXXXXXXXXXXXXXXXXX---XX--XXXXXXXXXXXXXXXXXXXXXXXXXXXXXXXXXXXXXXXXXXXXXXXXXXXX--XXXXX
XXXXXXXXXXX-XXXXXXXX-XXXXXXXXXXXXXXXXXXXXXX-XXXXXXXXXXXXXXXXXXXXXXXXXXXXXXXXXXXXXXXX---XX--XXXXXXXXXXXXXXXXXXXXXXXXXXXXXXXXXXXXXXXXXXXXXXXXXXXX--XXXXX
XXXXXXXXXXX-XXXXXXXX-XXXXXXXXXXXXXXXXXXXXXX-XXXXXXXXXXXXXXXXXXXXXXXXXXXXXXXXXXXXXXXX---XX--XXXXXXXXXXXXXXXXXXXXXXXXXXXXXXXXXXXXXXXXXXXXXXXXXXXX--XXXXX
