M-----------------------------------------------------------------------------------------------------------------------------------------------------
------------------------------------------------------------------------------------------------------------------------------------------------------
------------------------------------------------------------------------------------------------------------------------------------------------------
------------------------------------------------------------------------------------------------------------------------------------------------------
------------------------------------------------------------------------------------------------------------------------------------------------------
----------------------------------------------------------------------------------------------------o----------------------------------------!!!------
------------------g----------------UU-----------------------------------------o---------------------o---oo--------------------------------------------
--o--------------UU--------------------g-----------------U------------------g-o--------------------oo---oo------------o-------------------------------
--o----------@@------------------------o---------o-------------------------@@-------------------oo-o----oo---------g--o---------------------------g---
--o----g------------------oo-------ttU-o---------o---tt-U------ooo--g---go-------------oooo-----oo-o-g-ott--*----XXXX-o----------------------XXXXXX@@@
-o----TT---------XX-gXXX-----------tt----tt----------tt--tt--oXXXX-tt--tto----XX-------oooo-----oo--tt-ott--*----XXXX----------k--tt---------XXXXXX---
-o-g--TT---------XXXXXXX-gXXXXXX-g-tt----tt-----gXXX-tt--tt--oXXXX-tt--tt-----XX-----------XXXX-----tt-ott--*--*-XXXX---------g---tt---------XXXXXX---
XXXXXXXXX---XXXXXXXXXXXXXXXXXXXXXXXXXXXXXXXXXXXXXXXXXXXXXXXXXXXXXXXXXXXXXXXXXXXX--XXXXXXXXXXXXXXXXXXXXXXXXXXXXXXXXXXXXXXXXXXXXXXXXXXXXXXXXXXXXXXXXXXXX
XXXXXXXXX---XXXXXXXXXXXXXXXXXXXXXXXXXXXXXXXXXXXXXXXXXXXXXXXXXXXXXXXXXXXXXXXXXXXX--XXXXXXXXXXXXXXXXXXXXXXXXXXXXXXXXXXXXXXXXXXXXXXXXXXXXXXXXXXXXXXXXXXXX
XXXXXXXXX---XXXXXXXXXXXXXXXXXXXXXXXXXXXXXXXXXXXXXXXXXXXXXXXXXXXXXXXXXXXXXXXXXXXX--XXXXXXXXXXXXXXXXXXXXXXXXXXXXXXXXXXXXXXXXXXXXXXXXXXXXXXXXXXXXXXXXXXXX
XXXXXXXXX---XXXXXXXXXXXXXXXXXXXXXXXXXXXXXXXXXXXXXXXXXXXXXXXXXXXXXXXXXXXXXXXXXXXX--XXXXXXXXXXXXXXXXXXXXXXXXXXXXXXXXXXXXXXXXXXXXXXXXXXXXXXXXXXXXXXXXXXXX
