M-----------------------------------------------------------------------------------------------------------------------------------------------------
------------------------------------------------------------------------------------------------------------------------------------------------------
------------------------------------------------------------------------------------------------------------------------------------------------------
----------L----------------------------------------------------------L--------------------------------------------------------------------------------
-----------------------------------------------------------------------------------------------------------ooo----------------------------------------
-----------L----------------------------o------------------------oo----------------------------------------ooo----------------------------------------
-------------------oo---L----------------------------------------oo--------------------------------------------------------------------o----o---------
----------k--------oo--------------LL--------------------ooo----ooo--k--g------------oooo---------------------k------------------------o-k--o---------
--------g----------oo-k----------------------------------ooo----o--g----L--------o---oooo-------------------g-------------LL-----------g----o---------
-------TT--tt--tt---g-------------L----tt-------tt--tt---ooo-*----tt-------*-----ooo-oooo-o--LL---LL-------tt------ooo----------XXXXX-tt---g----------
-----k-TT--tt--tt--tt---XX-tt------tt--tt-------tt--tt-------*----tt-------*------oo------o------k---XXXXX-tt--tt-----k---------XXXXX-tt--XXX---------
---g---TT--tt--tt--tt--gXX-tt--*---tt--tt-------tt--tt-------*--g-tt-XX----*-------------------g-----XXXXX-tt--tt---g-----XXX---XXXXX-tt--XXX-g-------
-XXXX-XXXXXXXXXXXXXXXXXXXXXXXXXXX-XXXXXXXXXXXXXXXXXXXXXXXXXXXXXXXXXXXXXXXXXXXXXXXXXXXXXXXXXXXXXXXXXXXXXXXXXXXXXXXXXXXX--XXXXX---XXXXXXXXX-XXXXXXXX--XX
-XXXX-XXXXXXXXXXXXXXXXXXXXXXXXXXX-XXXXXXXXXXXXXXXXXXXXXXXXXXXXXXXXXXXXXXXXXXXXXXXXXXXXXXXXXXXXXXXXXXXXXXXXXXXXXXXXXXXX--XXXXX---XXXXXXXXX-XXXXXXXX--XX
-XXXX-XXXXXXXXXXXXXXXXXXXXXXXXXXX-XXXXXXXXXXXXXXXXXXXXXXXXXXXXXXXXXXXXXXXXXXXXXXXXXXXXXXXXXXXXXXXXXXXXXXXXXXXXXXXXXXXX--XXXXX---XXXXXXXXX-XXXXXXXX--XX
-XXXX-XXXXXXXXXXXXXXXXXXXXXXXXXXX-XXXXXXXXXXXXXXXXXXXXXXXXXXXXXXXXXXXXXXXXXXXXXXXXXXXXXXXXXXXXXXXXXXXXXXXXXXXXXXXXXXXX--XXXXX---XXXXXXXXX-XXXXXXXX--XX
