M-----------------------------------------------------------------------------------------------------------------------------------------------------
------------------------------------------------------------------------------------------------------------------------------------------------------
------------------------------------------------------------------------------------------------------------------------------------------------------
------------------------------------------------------------------------------------------------------------------------------------------------------
-------------------------------------------------------g----------------------------------------------------------------------------------------------
----------------------@@-------------k----------------SS----------------------------------------------------------------------------------------------
------------------------------------g---------------o-----------------CC-----L-------@@-----------------------------------------------!!--------------
---------k------------------------oooo-----------------------------------------k-----------------------ooo---------o-------o!!--------------k---------
--------g----------------SSS------oooo-------------------oo-------------------g----k-----CC--------k-----o---------o-------o----@@---------g----------
------ooo---g------ko-XXX---------oooo-------------ttoXXXoo-----------------Ltt---g--tt@------g---g-XXXXXo----------SSS----k-------*------oo----------
-----kooo--XX-----g-o-XXX----o--k------XXXXX-g--*--tt-XXXoo-k---------XXXX---tt--tt--tt------XXX-tt-XXXXX---k-----XX------g--------*-XXXX-tt-----k----
---og-ooo--XX-*-XXXXogXXX----o-g-------XXXXXXXX-*--tt-XXX--g-----g----XXXX---tt--tt--tt------XXX-tt-XXXXX--g------XX----XXXXXXXX---*-XXXX-tt----g---*-
XXXXXXXXXXXXXXXXXXXXXXXXXXXXXXXXXXXXXXXXXXXXXXXXXXXXXXXXXXXXX-XXXXXXXXXXXX--XXXXXXXXXXXXXXX--XXXXXXXXXXXXXXXXXXXXXXXXXXXXXXXXXXXXXXXXXXXXXXXX-XXXXXXXX
XXXXXXXXXXXXXXXXXXXXXXXXXXXXXXXXXXXXXXXXXXXXXXXXXXXXXXXXXXXXX-XXXXXXXXXXXX--XXXXXXXXXXXXXXX--XXXXXXXXXXXXXXXXXXXXXXXXXXXXXXXXXXXXXXXXXXXXXXXX-XXXXXXXX
XXXXXXXXXXXXXXXXXXXXXXXXXXXXXXXXXXXXXXXXXXXXXXXXXXXXXXXXXXXXX-XXXXXXXXXXXX--XXXXXXXXXXXXXXX--XXXXXXXXXXXXXXXXXXXXXXXXXXXXXXXXXXXXXXXXXXXXXXXX-XXXXXXXX
XXXXXXXXXXXXXXXXXXXXXXXXXXXXXXXXXXXXXXXXXXXXXXXXXXXXXXXXXXXXX-XXXXXXXXXXXX--XXXXXXXXXXXXXXX--XXXXXXXXXXXXXXXXXXXXXXXXXXXXXXXXXXXXXXXXXXXXXXXX-XXXXXXXX
