M-----------------------------------------------------------------------------------------------------------------------------------------------------
------------------------------------------------------------------------------------------------------------------------------------------------------
------------------------------------------------------------------------------------------------------------------------------------------------------
------------------------L-----------------------------------------------------------------------------------------------------------------------------
----------------------------k-----------------------------------------------ooo-----------------------------o-----------------------------------------
--------------------------g--------LL---------------------------------------ooo-----------------------------o------------------------------LL--------g
-------------------------LL--------------------------------------------LLL--ooo-----------------------------o------------o--------------------------LL
---------------oo--o----k--------------LL-----------o--------------------------------------------------o--------k--------o----k-----------------------
------------L--oo--o--g-----------L---------------------LL-----oooo----------------k------------ooo----o------g-------------g----L-----k--------------
-oo--*---------------tt------tt-L--tt-L----------LL---------tt-oooo--------------g-----*-LL-----ooo----------tt------------tt--------g-----tt----*--tt
----k*-----o------k--tt--TT--tt----tt--tt-------------------tt-oooo--*-XXXX-tt-XXXX-*--*--------ook---XX-----tt--*-----k---tt------XXXXX---tt----*--tt
--g--*--*-------g--g-tt--TT--tt----tt--tt-----------XXXXXXX-tt-------*-XXXX-tt-XXXX-*--*--------g-----XX-----tt--*---g--XX-tt------XXXXX---tt----*--tt
XXXXXXXXXXXXXXXXXXXXXXXXXXXXXXXXXXXXXXXXXX--XXXXXXXXXXXXXXXXXXXXXXXXXXXXXXXXXXXXXXXXXXXXXXXX--XXXXXXXXXXXXXXXXXXXXXXXXXXXXXXXXXXXXXXXXXX--XXXX--XXXXXX
XXXXXXXXXXXXXXXXXXXXXXXXXXXXXXXXXXXXXXXXXX--XXXXXXXXXXXXXXXXXXXXXXXXXXXXXXXXXXXXXXXXXXXXXXXX--XXXXXXXXXXXXXXXXXXXXXXXXXXXXXXXXXXXXXXXXXX--XXXX--XXXXXX
XXXXXXXXXXXXXXXXXXXXXXXXXXXXXXXXXXXXXXXXXX--XXXXXXXXXXXXXXXXXXXXXXXXXXXXXXXXXXXXXXXXXXXXXXXX--XXXXXXXXXXXXXXXXXXXXXXXXXXXXXXXXXXXXXXXXXX--XXXX--XXXXXX
XXXXXXXXXXXXXXXXXXXXXXXXXXXXXXXXXXXXXXXXXX--XXXXXXXXXXXXXXXXXXXXXXXXXXXXXXXXXXXXXXXXXXXXXXXX--XXXXXXXXXXXXXXXXXXXXXXXXXXXXXXXXXXXXXXXXXX--XXXX--XXXXXX
