M-----------------------------------------------------------------------------------------------------------------------------------------------------
------------------------------------------------------------------------------------------------------------------------------------------------------
------------------------------------------------------------------------------------------------------------------------------------------------------
-----ooo----------------------------------------------------------------------------------------------------------------------------------------------
-----ooo------------L---------------------------------------------------------------------------------------------------------------------------------
-----ooo------------------------oo----ko------------------------------------LL----------------LL------------------------------------------------------
-------------LL---------------------g-------------------------------LL-------------L----------------------LL--LL-----LL-------------------------------
oo---------------------------------LL--------k-----o-----ooo--LL--------k-------------o-----------------o---------------oooo-----k---------LL---o-----
--------------------k--------L--g----------g-------o-----ooo------L---g---------------o--------------k--o----------------------g----------------------
-----tt-LL---tt---g------L-----XXX----XXX-tt-----g------------------XXXX----tt----Ltt---------tt---g----oLtt-Ltt-XXX-tt-XXXXX-tt----*--L-----------LL-
-tt--tt-----ktt--tt------------XXX-tt-XXX-tt----TT-----k-tt-XXXXX---XXXX-*--tt-----tt---------tt-XXXXX----tt--tt-XXX-tt-XXXXX-tt----*-----------------
-tt--tt---g--tt--tt------------XXX-tt-XXX-tt----TT---g---tt-XXXXX---XXXX-*--tt-----tt-XX-g----tt-XXXXX----tt--tt-XXX-tt-XXXXX-tt----*-----XXXXXXXX----
XXXXXXXXXXXXXXXXXXXXXXXXXXXXXXXXXXXXXXXXXXXXX--XXXXXXXXXXXXXXXXXX-XXXXXXXXXXXXX---XXXXXXXX---XXXXXXXXXXXXXXXXXXXXXXXXXXXXXXXXXXXX--XXXXXX-XXXXXXXXXXXX
XXXXXXXXXXXXXXXXXXXXXXXXXXXXXXXXXXXXXXXXXXXXX--XXXXXXXXXXXXXXXXXX-XXXXXXXXXXXXX---XXXXXXXX---XXXXXXXXXXXXXXXXXXXXXXXXXXXXXXXXXXXX--XXXXXX-XXXXXXXXXXXX
XXXXXXXXXXXXXXXXXXXXXXXXXXXXXXXXXXXXXXXXXXXXX--XXXXXXXXXXXXXXXXXX-XXXXXXXXXXXXX---XXXXXXXX---XXXXXXXXXXXXXXXXXXXXXXXXXXXXXXXXXXXX--XXXXXX-XXXXXXXXXXXX
XXXXXXXXXXXXXXXXXXXXXXXXXXXXXXXXXXXXXXXXXXXXX--XXXXXXXXXXXXXXXXXX-XXXXXXXXXXXXX---XXXXXXXX---XXXXXXXXXXXXXXXXXXXXXXXXXXXXXXXXXXXX--XXXXXX-XXXXXXXXXXXX
