M-----------------------------------------------------------------------------------------------------------------------------------------------------
------------------------------------------------------------------------------------------------------------------------------------------------------
------------------------------------------------------------------------------------------------------------------------------------------------------
------------------------------------------------------------------------------------------------------------------------------------------------------
----------------------------------o------------------------------------L----------------------------------------ooo-----------------------------------
----------------------------------o------------------oo---------------------------o-----------------------------ooo-------------LL-----------------ooo
---------------------------------k-------------------oo-------------L-------------------------------------------ooo-------------------o------------ooo
------------------o---------o--g------o--------------oo----------------k--------------LL----------------------------k---k---------------------k-------
-------L-----------k--------o-LL------o-------L--------k-o----ok-----g---------o-----------------L---------oo-----g---g--------------g--L---g-------g-
---XXXX-----LL---g-------*--o-----tt-----------------g-XXo---g--LL-Ltt-XX------o--XX-----------L--------tt-------tt-XXXX-------XXXXXXXX-----LL-----tt-
-*-XXXX---------tt-------*--------tt-------*-------XXXXXX---tt------tt-XX-oook----XX----------------tt--tt-------tt-XXXX----tt-XXXXXXXX------------tt-
-*-XXXX---------tt-XXXXX-*--------tt-------*-------XXXXXX---tt------tt-XX--g----g-XXXXXXX-g-----g-g-tt--tt-------tt-XXXX----tt-XXXXXXXX------------tt-
XXXXXXXXX---XXXXXXXXXXXXXXXXXXXXXXXXXXX---XXXXXX---XXXXXXXXXXXXXXXXXXXXXXXXXXXXXXXXXXXXXXXXX---XXXXXXXXXXXXXXXXXXXXXXXXXXXXXXXXXXXXXXXXXXXXXXXXXXXXXXX
XXXXXXXXX---XXXXXXXXXXXXXXXXXXXXXXXXXXX---XXXXXX---XXXXXXXXXXXXXXXXXXXXXXXXXXXXXXXXXXXXXXXXX---XXXXXXXXXXXXXXXXXXXXXXXXXXXXXXXXXXXXXXXXXXXXXXXXXXXXXXX
XXXXXXXXX---XXXXXXXXXXXXXXXXXXXXXXXXXXX---XXXXXX---XXXXXXXXXXXXXXXXXXXXXXXXXXXXXXXXXXXXXXXXX---XXXXXXXXXXXXXXXXXXXXXXXXXXXXXXXXXXXXXXXXXXXXXXXXXXXXXXX
XXXXXXXXX---XXXXXXXXXXXXXXXXXXXXXXXXXXX---XXXXXX---XXXXXXXXXXXXXXXXXXXXXXXXXXXXXXXXXXXXXXXXX---XXXXXXXXXXXXXXXXXXXXXXXXXXXXXXXXXXXXXXXXXXXXXXXXXXXXXXX
