M-----------------------------------------------------------------------------------------------------------------------------------------------------
------------------------------------------------------------------------------------------------------------------------------------------------------
------------------------------------------------------------------------------------------------------------------------------------------------------
------------------------------------------------------------------------------------------------------------------------------------------------------
----------------------o------------------------------------------o------------------------------------------------------------------------------------
----------------------o------------------------------------------o-----------------------------------------------o---------------k--------------------
----------------------o------------------------------------------o-----------------------------------------------o--------!!----g---------------------
-----------k--S---------CCC-------------------------------------o-----------------------------------CC-------UU--o-------------oo---------------------
-------k--g-------------------oo-----------------------!!-------o---------k---k------UUU-----o---------------------k--g-------------------------------
------g--tt----S-----XX-----ttoo---o--------XX-tt---------*--TT-ott------g---g-UUU--------*------------LLL-----U--g--XXX------XXXXX-------tt----------
-tt-ooo--tt--tt--*---XX-----ttoott-o---oo---XX-ttooo------*--TT--tt--*--tt--tt------------*------------------tt-XXXXXXXX-XXXXXXXXXX-*-oo--tt-------k--
-tt------tt--tt--*--gXXXXXX-tt--tt-og--oo---XX-ttooo------*--TT--tt--*--tt--tt------------*-XX-----XXXX------tt-XXXXXXXX-XXXXXXXXXX-*-oo--tt------g-XX
XXXXXXXXXXXXXXXXXXXXXXXXXXXXXXXXXXXXXX-XXXXXXXXXXXXXXXXXXXXXXXXXXXXXXXXXXXXXXXXXXXXXXXXX-XXXXX--XXXXXXXXXXXXXXXXXXXXXXXX-XXXXXXXXXXXXXXXXXXXX---XXXXXX
XXXXXXXXXXXXXXXXXXXXXXXXXXXXXXXXXXXXXX-XXXXXXXXXXXXXXXXXXXXXXXXXXXXXXXXXXXXXXXXXXXXXXXXX-XXXXX--XXXXXXXXXXXXXXXXXXXXXXXX-XXXXXXXXXXXXXXXXXXXX---XXXXXX
XXXXXXXXXXXXXXXXXXXXXXXXXXXXXXXXXXXXXX-XXXXXXXXXXXXXXXXXXXXXXXXXXXXXXXXXXXXXXXXXXXXXXXXX-XXXXX--XXXXXXXXXXXXXXXXXXXXXXXX-XXXXXXXXXXXXXXXXXXXX---XXXXXX
XXXXXXXXXXXXXXXXXXXXXXXXXXXXXXXXXXXXXX-XXXXXXXXXXXXXXXXXXXXXXXXXXXXXXXXXXXXXXXXXXXXXXXXX-XXXXX--XXXXXXXXXXXXXXXXXXXXXXXX-XXXXXXXXXXXXXXXXXXXX---XXXXXX
