M-----------------------------------------------------------------------------------------------------------------------------------------------------
------------------------------------------------------------------------------------------------------------------------------------------------------
------------------------------------------------------------------------------------------------------------------------------------------------------
----------oo------------------------------------------------------------------------------------------------------------------------------------------
----------oo----k-------------------------------------o-----------------------------------------------------------------------------------------------
----------oo--g---------------------------------------o-------------------k----------------------------------o----------------------------------------
----o--------LL------L------oo------------------o-----o------------LL---g------------------------------------o----------------------------------------
--------k---k---------------oo-----k------------o-------------oo--------L---L----------------------------k--------------------------------------------
------g---g------L----------oo---g-----k----LL--o--L-----k--------L---------------oo-oo---o------------g-------------------oo-------------------------
-----tt--tt--TT-----------------tt---g-----------------g--LL-------------------*-----oo----g--ooo-tt--TT-------------------oo---------L---------------
----ktt--tt--TT-----tt--------k-tt--tt----------g----XXXXX-----tt--tt--tt------*--------*-XXX-oooktt--TT----XX--oo--tt---g------------------k----o----
--g--tt--tt--TT-XXX-tt--*---g---tt--tt---------XXX---XXXXX-----tt--tt--tt---XX-*----XXX-*-XXX--g--tt--TT----XX------tt--XX-------------g--g-------XXXX
XXXXXXXXXXXXXXXXXXXXXXXXXXXXXXXXXXXXXXX-XXX-XXXXXXXXXXXXXXXXXXXXXXXXXXXXXX--XXXXXXXXXXXXXXXXXXXXXXXXXXXXX---XXXXXXXXXXX-XXXXXXXXXXX---XXXXXXXXXXXXXXXX
XXXXXXXXXXXXXXXXXXXXXXXXXXXXXXXXXXXXXXX-XXX-XXXXXXXXXXXXXXXXXXXXXXXXXXXXXX--XXXXXXXXXXXXXXXXXXXXXXXXXXXXX---XXXXXXXXXXX-XXXXXXXXXXX---XXXXXXXXXXXXXXXX
XXXXXXXXXXXXXXXXXXXXXXXXXXXXXXXXXXXXXXX-XXX-XXXXXXXXXXXXXXXXXXXXXXXXXXXXXX--XXXXXXXXXXXXXXXXXXXXXXXXXXXXX---XXXXXXXXXXX-XXXXXXXXXXX---XXXXXXXXXXXXXXXX
XXXXXXXXXXXXXXXXXXXXXXXXXXXXXXXXXXXXXXX-XXX-XXXXXXXXXXXXXXXXXXXXXXXXXXXXXX--XXXXXXXXXXXXXXXXXXXXXXXXXXXXX---XXXXXXXXXXX-XXXXXXXXXXX---XXXXXXXXXXXXXXXX
