M-----------------------------------------------------------------------------------------------------------------------------------------------------
------------------------------------------------------------------------------------------------------------------------------------------------------
------------------------------------------------------------------------------------------------------------------------------------------------------
-------------oo--L--------------------------------------o------------------------------------o--------------------------------------------------------
-------------oo-----------------------------oo----------o------------------------------------o--------------------------------------------------------
-------------oo-------------k---------------oo----------o------------------------------------o--------------------------------------------------------
--------------------------g-----------------oo-------L-----------------------------------------------------o--------k---------------------------------
------ooo-LL-----k-------LL--o-L---------------------------------------------------o-----------------------o------g-----------------LL------------LL--
------ooo------g--g----------o------oo---LL----------------oo---oooo--o------------o--------------------k--o-ooo--LL--------------------ooo-----------
------ooo-----TT-XX-----L-----L-----oo-------g------XXX-tt-oo---oooo--o--tt--------o---LL-----tt------g------ooo----------------TT--------------------
----k----ktt--TT-XX------tt----tt-----k*----XXXXXXXXXXX-tt-oo--koooo--g--tt-----g-------------tt-XXX-tt-------------------------TT------tt-----k--tt--
--g----g--tt--TT-XX-*----tt----tt---g--*-XXXXXXXXXXXXXX-tt---g-------XXX-tt----XXX-g-------*--tt-XXX-tt---g---------------XXXXX-TT-XXXX-tt---g----tt--
XXXXXXXXXXXXXXXXXXXXXX--XXXXXXXXXXXXXXXXXXXXXXXXXXXXXXXXXXXXXXXXXXXXXXXXXXXX---XXXXXXXXXXXXXXXXXXXXXXXXX-XXXXXXXXXXXXXXXXXXXXXXXXXXXXXXXXXXXXXXXXXXXXX
XXXXXXXXXXXXXXXXXXXXXX--XXXXXXXXXXXXXXXXXXXXXXXXXXXXXXXXXXXXXXXXXXXXXXXXXXXX---XXXXXXXXXXXXXXXXXXXXXXXXX-XXXXXXXXXXXXXXXXXXXXXXXXXXXXXXXXXXXXXXXXXXXXX
XXXXXXXXXXXXXXXXXXXXXX--XXXXXXXXXXXXXXXXXXXXXXXXXXXXXXXXXXXXXXXXXXXXXXXXXXXX---XXXXXXXXXXXXXXXXXXXXXXXXX-XXXXXXXXXXXXXXXXXXXXXXXXXXXXXXXXXXXXXXXXXXXXX
XXXXXXXXXXXXXXXXXXXXXX--XXXXXXXXXXXXXXXXXXXXXXXXXXXXXXXXXXXXXXXXXXXXXXXXXXXX---XXXXXXXXXXXXXXXXXXXXXXXXX-XXXXXXXXXXXXXXXXXXXXXXXXXXXXXXXXXXXXXXXXXXXXX
