M-----------------------------------------------------------------------------------------------------------------------------------------------------
------------------------------------------------------------------------------------------------------------------------------------------------------
------------------------------------------------------------------------------------------------------------------------------------------------------
------------------------------------------k-------------------------------------------------------------------------------oo--------------------------
----------------------------------------g---------------------------------------------------------------------------------oo--------------------------
------------------------L--------------LL---------------------------------------------o-----------------------------------oo--------------------------
-----------------------------o------------------LL------------------------------------o-----------------------------------------k-----------------k-oo
---------------------------------------------------------LL---------------------------o--LL---------------------------------k-g-----------------g---oo
---------------------L-L-------k------k----LL----------------------------------------------------k------k-----------------g--LL------LL------o-LLL----
-g-*--------------------tt---g------g--tt-------tt--oo--------------------XXXXX---*-XXX------k-g------g--L---------------tt--------------tt----------g
XX-*-----XXXX-----------tt--tt-----tt--tt-------tt-------tt--------tt-----XXXXX---*-XXX----g--tt----XXXXX----------*--*--tt--------*-----tt--------XXX
XX-*-----XXXXXXXX-------tt--tt--*--tt--tt-XXXXX-tt-------tt--------tt-----XXXXX---*-XXX--XXXX-tt----XXXXX----------*--*--tt--------*-----tt-XXXXXXXXXX
XXXXXXXXXXXXXXXXXXXXXXXXXXXXXXXXXXXXXXXXXXXXXXXXXXXXXXXXXXXX---XXXXXXXXXXXXXXXX--XXXXXX--XXXXXXXX---XXXXXXX--XXXXXXXXXXXXXXXXXXXXXXXXXXXXXXXXXXXXXXXXX
XXXXXXXXXXXXXXXXXXXXXXXXXXXXXXXXXXXXXXXXXXXXXXXXXXXXXXXXXXXX---XXXXXXXXXXXXXXXX--XXXXXX--XXXXXXXX---XXXXXXX--XXXXXXXXXXXXXXXXXXXXXXXXXXXXXXXXXXXXXXXXX
XXXXXXXXXXXXXXXXXXXXXXXXXXXXXXXXXXXXXXXXXXXXXXXXXXXXXXXXXXXX---XXXXXXXXXXXXXXXX--XXXXXX--XXXXXXXX---XXXXXXX--XXXXXXXXXXXXXXXXXXXXXXXXXXXXXXXXXXXXXXXXX
XXXXXXXXXXXXXXXXXXXXXXXXXXXXXXXXXXXXXXXXXXXXXXXXXXXXXXXXXXXX---XXXXXXXXXXXXXXXX--XXXXXX--XXXXXXXX---XXXXXXX--XXXXXXXXXXXXXXXXXXXXXXXXXXXXXXXXXXXXXXXXX
