M-----------------------------------------------------------------------------------------------------------------------------------------------------
------------------------------------------------------------------------------------------------------------------------------------------------------
------------------------------------------------------------------------------------------------------------------------------------------------------
------------------------------------------------------------------------------------------------------------------------------------------------------
--------------------------------------------------------ooo-------------------------------------------------------------------------------------------
--LL---------------------oo-----------------------------ooo---------------------------------------------LL------L------------------------oo-----------
-------------------------oo---------------LL------------ooo---------------koooo---------------------LL-------------o-----o-----g---------oo-----------
---------------------o------------------------LL------------------------g--oooo-----k----------------------LL------o-----o-----L----------------------
-------L----------------k---k----------L-------------------------------LLL-oooo---g--------------------------------o-----o---------------g---oo-------
--tt------------------g---g---------------tt------ooo----tt------LL--------------tt-----------------tt--tt------XX--------------------L-XXX--oo-------
--tt----------------XXXXXXXXX----k---k----tt--tt--ooo-*--tt--tt----------------k-tt-----k-------k---tt--tt-XXXXXXX----tt-----kXXX-------XXX-----------
--tt-XXXX-XXX-------XXXXXXXXX--g---g------tt--tt------*--tt--tt--------------g---tt---g-------g-----tt--tt-XXXXXXX----tt---g--XXXXXXXX--XXX-----------
-XXXXXXXX-XXX---XXXXXXXXXXXXXXXXXXXXXXXXXXXXXXXXXXXXXXXXXXXXXXXXXXXX--XXXXXXXXXXXXXXXXXXX---XXXX---XXXXXXXXXXXXXXXXXXXXXXXXXXXXXXXXXXXXXXXXXXXXXXXXXXX
-XXXXXXXX-XXX---XXXXXXXXXXXXXXXXXXXXXXXXXXXXXXXXXXXXXXXXXXXXXXXXXXXX--XXXXXXXXXXXXXXXXXXX---XXXX---XXXXXXXXXXXXXXXXXXXXXXXXXXXXXXXXXXXXXXXXXXXXXXXXXXX
-XXXXXXXX-XXX---XXXXXXXXXXXXXXXXXXXXXXXXXXXXXXXXXXXXXXXXXXXXXXXXXXXX--XXXXXXXXXXXXXXXXXXX---XXXX---XXXXXXXXXXXXXXXXXXXXXXXXXXXXXXXXXXXXXXXXXXXXXXXXXXX
-XXXXXXXX-XXX---XXXXXXXXXXXXXXXXXXXXXXXXXXXXXXXXXXXXXXXXXXXXXXXXXXXX--XXXXXXXXXXXXXXXXXXX---XXXX---XXXXXXXXXXXXXXXXXXXXXXXXXXXXXXXXXXXXXXXXXXXXXXXXXXX
