M-----------------------------------------------------------------------------------------------------------------------------------------------------
------------------------------------------------------------------------------------------------------------------------------------------------------
------------------------------------------------------------------------------------------------------------------------------------------------------
------------------------------------------------------------------------------------------------------------------------------------------------------
-----------------------------------oo---oo-----------------------k-------------------------------------------------------------------k---k------------
-----------------------------LL----oo---oo---------------------g-----------------ooo-----------------------------------------------g---g--------------
-----------------------------------oo------o----------LL-------L-----------------ooo-----------o-----------LL---------------------LL--LL--------------
-------L----o-------oo-----------------k---o-------------------------------------ooo-LL--------o---------------g-------LLL----------------------------
------------o------------------------g--------------o-------------o------------------------oo------------------L--------------------------------------
----------*-----o--XXX-------XXX---XXXX-tt----------------LL--tt----------L-L--*---------------------------tt--------------------Ltt--tt----XXXXXLL-XX
------tt--*-----o--XXX-------XXX---XXXX-tt--tt--------tt------tt-XXXX-tt-------*--tt----------ktt----tt----tt-----tt--------------tt--tt----XXXXX---XX
XXXXX-tt--*--g---g-XXX----gXXXXX-*-XXXX-tt--tt----g-g-tt------tt-XXXX-tt-----g-*--tt-XXXXX--g--tt----tt----tt-----tt---XXXX----*--tt--tt----XXXXX---XX
XXXXXXXXXXXXXXXXXXXXXXXXXXXXXXXXXXXXXXXXXXXXXXX--XXXXXXXXXXXXXXXXXXXXXXXXXXXXXXXXXXXXXXXXXXXXXXXXXXXXXXX--XXXXXXXXXXX--XXXX---XXXXXXXXXXXXXXXXXXXXXXXX
XXXXXXXXXXXXXXXXXXXXXXXXXXXXXXXXXXXXXXXXXXXXXXX--XXXXXXXXXXXXXXXXXXXXXXXXXXXXXXXXXXXXXXXXXXXXXXXXXXXXXXX--XXXXXXXXXXX--XXXX---XXXXXXXXXXXXXXXXXXXXXXXX
XXXXXXXXXXXXXXXXXXXXXXXXXXXXXXXXXXXXXXXXXXXXXXX--XXXXXXXXXXXXXXXXXXXXXXXXXXXXXXXXXXXXXXXXXXXXXXXXXXXXXXX--XXXXXXXXXXX--XXXX---XXXXXXXXXXXXXXXXXXXXXXXX
XXXXXXXXXXXXXXXXXXXXXXXXXXXXXXXXXXXXXXXXXXXXXXX--XXXXXXXXXXXXXXXXXXXXXXXXXXXXXXXXXXXXXXXXXXXXXXXXXXXXXXX--XXXXXXXXXXX--XXXX---XXXXXXXXXXXXXXXXXXXXXXXX
