M-----------------------------------------------------------------------------------------------------------------------------------------------------
------------------------------------------------------------------------------------------------------------------------------------------------------
------------------------------------------------------------------------------------------------------------------------------------------------------
------------------------------------------------------------------------------------------------------------------------------------------------------
------------------------------------------------------------------------------------------------------------------------------------------------------
-----------------------------ooo------------------------------o---------------------------------------------------------------------------------------
----------LL------k----------ooo------------------------------o-------------L---LL---------L--LL------------------L--------o-----------------------o--
----------------g------------ooooo------------L---------------o-----LLL------------------k-------------------------L-------o--------------------------
-------oo------LL----L----------oo--o------------------------------------------L----o--g-----------------------------------o-------------------------k
---L---oo--------------------tt-oo-----------L----------------XXXX-------XXXXX------o-TT------tt-----k-tt------------------------*-------XXXXX-----g--
-------ooXXXXX---------------tt---------------tt--tt--tt-XXXXXXXXXXXXXXXXXXXXX--tt--o-TT--tt--tt---g---tt-----k---k------tt--tt--*-------XXXXX----tt--
-------g-XXXXX--------g------tt-XXXXXXX-*--*--tt--tt--tt-XXXXXXXXXXXXXXXXXXXXX--tt--g-TT--tt--tt-XXXX--tt---g---g-XXX----tt--tt--*-------XXXXX-g--tt--
--XXXXXXXXXXXXXXXXXXXXXXXXXXXXXXXXXXXXXXXXXXXXXXXXXXXXXXXXXXXXXXXXXXXXXXXXXXXX-XXXXXXXXXXXXXXXXXXXXXX-XXXXXXXXXXXXXXX---XXXXXXXXXXX--XXXXXXXXXXXXXXXXX
--XXXXXXXXXXXXXXXXXXXXXXXXXXXXXXXXXXXXXXXXXXXXXXXXXXXXXXXXXXXXXXXXXXXXXXXXXXXX-XXXXXXXXXXXXXXXXXXXXXX-XXXXXXXXXXXXXXX---XXXXXXXXXXX--XXXXXXXXXXXXXXXXX
--XXXXXXXXXXXXXXXXXXXXXXXXXXXXXXXXXXXXXXXXXXXXXXXXXXXXXXXXXXXXXXXXXXXXXXXXXXXX-XXXXXXXXXXXXXXXXXXXXXX-XXXXXXXXXXXXXXX---XXXXXXXXXXX--XXXXXXXXXXXXXXXXX
--XXXXXXXXXXXXXXXXXXXXXXXXXXXXXXXXXXXXXXXXXXXXXXXXXXXXXXXXXXXXXXXXXXXXXXXXXXXX-XXXXXXXXXXXXXXXXXXXXXX-XXXXXXXXXXXXXXX---XXXXXXXXXXX--XXXXXXXXXXXXXXXXX
