M-----------------------------------------------------------------------------------------------------------------------------------------------------
------------------------------------------------------------------------------------------------------------------------------------------------------
-------------------------------k----------------------------------------------------------------------------------------------------------------------
------------------------------g-----------------------------------------------------------------------------------------------------------------------
----------g-----------------ooo-------g-------------------------------------------------------------------------------------------------g-------------
----------o-----------------ooo-------o--o------------------------------------------oooo---------------LL-------------------------------oo------------
-o--------o-----------------ooo-------o--o--g-----------------------------k---------oooo------------------------g-----------LL----------oo------------
----------o--g-------------------ooo-----oooo----------------------------g------------------------@@------o-----oo----------------------oo-----g------
-------------o-------------------ooo------ooo-----------g-------g-------oooo-----------------------------Lo-----oo----------------------------CC------
XXo--tt------o----------g---XXXXX----XXXXXooo--tt--tt--oo------tto-----XXXXX-------XXXXXXXXXX-ooo------tt-o----XXX---oo----XXXXX---tt-----------------
XXo--tt-XXXX-------ooooXX---XXXXX----XXXXXXXXX-tt--tt--oo------tto-----XXXXXXXXX-*-XXXXXXXXXX-ooo------tt-XX-g-XXX-*-------XXXXX---tt-XXXX-oo---------
XX---tt-XXXXXX-----ooooXX---XXXXXXXXXXXXXXXXXX-tt--tt-------g--tto-----XXXXXXXXX-*-XXXXXXXXXXXXXXXXX---tt-XXXXXXXX-*-------XXXXX-g-tt-XXXX-oo---------
XXXXXXXXXXXXXX----XXXXXXXXXXXXXXXXXXXXXXXXXXXXXXXXXXXXXXXXXXXXXXXXXXXXXXXXXXXXXXXXXXXXXXXXXXXXXXXXXXXXXXXXXXXXXXXXXXXXXXXXXXXXXXXXXXXXXXXXXXXXXXX---XX
XXXXXXXXXXXXXX----XXXXXXXXXXXXXXXXXXXXXXXXXXXXXXXXXXXXXXXXXXXXXXXXXXXXXXXXXXXXXXXXXXXXXXXXXXXXXXXXXXXXXXXXXXXXXXXXXXXXXXXXXXXXXXXXXXXXXXXXXXXXXXX---XX
XXXXXXXXXXXXXX----XXXXXXXXXXXXXXXXXXXXXXXXXXXXXXXXXXXXXXXXXXXXXXXXXXXXXXXXXXXXXXXXXXXXXXXXXXXXXXXXXXXXXXXXXXXXXXXXXXXXXXXXXXXXXXXXXXXXXXXXXXXXXXX---XX
XXXXXXXXXXXXXX----XXXXXXXXXXXXXXXXXXXXXXXXXXXXXXXXXXXXXXXXXXXXXXXXXXXXXXXXXXXXXXXXXXXXXXXXXXXXXXXXXXXXXXXXXXXXXXXXXXXXXXXXXXXXXXXXXXXXXXXXXXXXXXX---XX
