M-----------------------------------------------------------------------------------------------------------------------------------------------------
------------------------------------------------------------------------------------------------------------------------------------------------------
------------------------------------------------------------------------------------------------------------------------------------------------------
------------------------------------------------------------------------------------------------------------------------------------------------------
----k-------------------------k-----------------------------------k---------------------------------------------------------------oo------------------
--g-------------------------g-----------------------L-----------g------------------------------------------o----------------------oo------------------
-LL-oo----------------------LL--ooo----------------------------LL-o---o------------------ooo---------------o----------------------oo------------------
----oo--------------------------------------------------k---------o----------------------ooo---------------o------------------------------------------
---------------ook-----LL---------------------------k-g---------------------------o------ooo---oo---L----------LL--------------------------------LL---
-tt--tt-----k--g----------------tt-LL-------------g--LL----LL-XXXX----------------o--------------k*----tt-----------LLL--tt-oo--L-XXXXX-L-----tt------
-tt--tt---g---tt----XXX---XXXXX-tt---------------tt-----------XXXX----XXXX----*---o------------g--*----tt-XX------XX-----tt-oo----XXXXX-------tt------
-tt--tt-XXXXX-tt--*-XXX---XXXXX-tt-----g---------tt-----------XXXXXXX-XXXX----*----g---------XXXX-*----tt-XX------XX-----tt--g----XXXXX-------tt------
XXXXXXXXXXXXXXXXXXXXXXXXXXXXXXXXXXXXXXXXX--XXXXXXXXXXXXXXXXXXXXXXXXXX-XXXXXXXXXX--XXXXXXXXXXXXXXXXXXXXXXXXXX--XXXXXXXXXXXXXXXXXXXXXXXXXXXX---XXXXXXXXX
XXXXXXXXXXXXXXXXXXXXXXXXXXXXXXXXXXXXXXXXX--XXXXXXXXXXXXXXXXXXXXXXXXXX-XXXXXXXXXX--XXXXXXXXXXXXXXXXXXXXXXXXXX--XXXXXXXXXXXXXXXXXXXXXXXXXXXX---XXXXXXXXX
XXXXXXXXXXXXXXXXXXXXXXXXXXXXXXXXXXXXXXXXX--XXXXXXXXXXXXXXXXXXXXXXXXXX-XXXXXXXXXX--XXXXXXXXXXXXXXXXXXXXXXXXXX--XXXXXXXXXXXXXXXXXXXXXXXXXXXX---XXXXXXXXX
XXXXXXXXXXXXXXXXXXXXXXXXXXXXXXXXXXXXXXXXX--XXXXXXXXXXXXXXXXXXXXXXXXXX-XXXXXXXXXX--XXXXXXXXXXXXXXXXXXXXXXXXXX--XXXXXXXXXXXXXXXXXXXXXXXXXXXX---XXXXXXXXX
