M-----------------------------------------------------------------------------------------------------------------------------------------------------
------------------------------------------------------------------------------------------------------------------------------------------------------
------------------------------------------------------------------------------------------------------------------------------------------------------
------------------------------------------------------------------------------------------------------------------------------------------------------
---------------------------------------------oo-------------------------------------------------------------------------------------------------------
-----------------------------ooo-------------oo---------------L--o------------------------o-----------------------------k-----------------------------
-----------------------------------oo--------oo-LL---------------o------------------------o---------------------------g-------------------------------
---------------------------------k-oo---------------------------------k----------------------------------------------LL---------o---------------------
--------oo---------k-----------g---oo----------k-----LLL--o---------g---------------------------------------------------------------------------------
--------g--------g-----------XXXX-------tt---g------------o--tt--gLLL------*--LLL--tt-o----g--------------L---oo--------------------------------------
-tt----XXX----k-tt-----------XXXX-------tt--tt--tt---------g-tt-XX---------*-------tt-o---XXX-------------------k----tt-------------*-------o--------k
-tt----XXX--g---tt--g--------XXXX-gXXXX-tt--tt--tt--------XX-tt-XX---------*-------tt----gXXX-----------------g------tt--------XXXX-*-------g------g--
XXXX---XXXXXXXXXXXXXXXXXXXXXXXXXXXXXXXXXXXXXXXXXXXX--XXXXXXXXXXXXXXXXXXXXXXXXXXXXXXXXXXXXXXXX----XXXXXXXXXXXXXXXXXXXXXXX---XXXXXXXXXXXXXXXXXX-XXXXXXXX
XXXX---XXXXXXXXXXXXXXXXXXXXXXXXXXXXXXXXXXXXXXXXXXXX--XXXXXXXXXXXXXXXXXXXXXXXXXXXXXXXXXXXXXXXX----XXXXXXXXXXXXXXXXXXXXXXX---XXXXXXXXXXXXXXXXXX-XXXXXXXX
XXXX---XXXXXXXXXXXXXXXXXXXXXXXXXXXXXXXXXXXXXXXXXXXX--XXXXXXXXXXXXXXXXXXXXXXXXXXXXXXXXXXXXXXXX----XXXXXXXXXXXXXXXXXXXXXXX---XXXXXXXXXXXXXXXXXX-XXXXXXXX
XXXX---XXXXXXXXXXXXXXXXXXXXXXXXXXXXXXXXXXXXXXXXXXXX--XXXXXXXXXXXXXXXXXXXXXXXXXXXXXXXXXXXXXXXX----XXXXXXXXXXXXXXXXXXXXXXX---XXXXXXXXXXXXXXXXXX-XXXXXXXX
