M-----------------------------------------------------------------------------------------------------------------------------------------------------
------------------------------------------------------------------------------------------------------------------------------------------------------
------------------------------------------------------------------------------------------------------------------------------------------------------
------------------------------------------------------------------------------------------------------------------------------------------------------
------------------------------------------------------------------------------------------------------------------------------------------------------
-o-------------------------LL-----------------oo-----------------------------------------------------------LL-----------------------------------------
-o----------------k-ooo-------o-----L----------------L-------oo-------------------------------------------------------------LL------------------------
----------------g---oook------o--oo-------------k------------oo-------------------------------------------------------------------------------------k-
----k----------LLL---g--L-----o--oo----LL-----g--------------oo-kooo----ooo-k------LL--------------------------L---LL----o-----oooo---------------g---
--g-----XXXXXX------tt-----tt------XXX-------tt------XXXXXXX--g-----------g------------XXXX-tt--------LL---tt------------o-XXXXoooo-------gLL----LL--X
-tt-----XXXXXX------tt-----tt------XXX-------tt-XX---XXXXXXX-tt----------tt------------XXXX-tt-XXXX--------tt------------okXXXXoooo------XX----------X
-tt---g-XXXXXX------tt-XXX-tt----g-XXX-------tt-XX---XXXXXXX-tt----------tt------------XXXX-tt-XXXX--------tt-----------g--XXXX------g---XX----------X
XXXXXXXXXXXXXXXXXXXXXXXXXXXXXXXXXXXXXXXXXX--XXXXXXXXXXXXXXXXXXXXXXXXX---XXXX--XXXXXXXXXXXXXXXXXXXXXXXXXXXXXXXXXXXXXXXXXXXXXXXXXXXXXXXX---XXXXXXXXXXXXX
XXXXXXXXXXXXXXXXXXXXXXXXXXXXXXXXXXXXXXXXXX--XXXXXXXXXXXXXXXXXXXXXXXXX---XXXX--XXXXXXXXXXXXXXXXXXXXXXXXXXXXXXXXXXXXXXXXXXXXXXXXXXXXXXXX---XXXXXXXXXXXXX
XXXXXXXXXXXXXXXXXXXXXXXXXXXXXXXXXXXXXXXXXX--XXXXXXXXXXXXXXXXXXXXXXXXX---XXXX--XXXXXXXXXXXXXXXXXXXXXXXXXXXXXXXXXXXXXXXXXXXXXXXXXXXXXXXX---XXXXXXXXXXXXX
XXXXXXXXXXXXXXXXXXXXXXXXXXXXXXXXXXXXXXXXXX--XXXXXXXXXXXXXXXXXXXXXXXXX---XXXX--XXXXXXXXXXXXXXXXXXXXXXXXXXXXXXXXXXXXXXXXXXXXXXXXXXXXXXXX---XXXXXXXXXXXXX
