M-----------------------------------------------------------------------------------------------------------------------------------------------------
------------------------------------------------------------------------------------------------------------------------------------------------------
------------------------------------------------------------------------------------------------------------------------------------------------------
------------------------------------------------------------------------------------------------------------------------------------------------------
------------------------------------------------------------------------------------------------------------------------------------------------------
-----------------------------------------------------------g---g-------------------------g---------g--------------------------------------------------
-------------------------------------------!-----------@---o--oo------------oo----------LL--------SS--------g-----------------------------------------
----------------k--------------------------------o------------------------o-----!!-------------------------SS-----------------------------o-----------
---------------g--o--------------------!!------g-o------@-------------g--g-------------------------------------!!!------------------g-----o------g----
---ott--tt--oXXXXXo---CCC---tt-o----------!tt-XXX--o------tto-tto----tt-XXX-tt----!-oooLtt-XX---k-XX---------S------UU-----------o--o-----o-----tt-o--
---ott--tt---XXXXXo---------tt-o-----------tt-XXXXXXX-tt--tt--tt-----tt-XXX-tt--tt--ooo-tt-XX--g--XX-----o-TT-----------o------o-o-XXX-------*--tt-XXX
----tt--tt---XXXXX----------tt-----ooo-----tt-XXXXXXX-tt--tt--tt--g--tt-XXX-tt--tt------tt-XXXXXXXXX-*-----TT--------------------ogXXX----XX-*--tt-XXX
XXXXXXXXXXXXXXXXXXXXXXXXXXXXXXXXXXXXXXXXXXXXXXXXXXXXXXXXXXXXXXXXXXXXXXXXXXXXXXXXXXXXXXXXXXXXXXXXXXXXXXXXXXXXXXXXXXXXXXXXXXX----XXXXXXX----XXXXXXXXXXXX
XXXXXXXXXXXXXXXXXXXXXXXXXXXXXXXXXXXXXXXXXXXXXXXXXXXXXXXXXXXXXXXXXXXXXXXXXXXXXXXXXXXXXXXXXXXXXXXXXXXXXXXXXXXXXXXXXXXXXXXXXXX----XXXXXXX----XXXXXXXXXXXX
XXXXXXXXXXXXXXXXXXXXXXXXXXXXXXXXXXXXXXXXXXXXXXXXXXXXXXXXXXXXXXXXXXXXXXXXXXXXXXXXXXXXXXXXXXXXXXXXXXXXXXXXXXXXXXXXXXXXXXXXXXX----XXXXXXX----XXXXXXXXXXXX
XXXXXXXXXXXXXXXXXXXXXXXXXXXXXXXXXXXXXXXXXXXXXXXXXXXXXXXXXXXXXXXXXXXXXXXXXXXXXXXXXXXXXXXXXXXXXXXXXXXXXXXXXXXXXXXXXXXXXXXXXXX----XXXXXXX----XXXXXXXXXXXX
