M-----------------------------------------------------------------------------------------------------------------------------------------------------
------------------------------------------------------------------------------------------------------------------------------------------------------
------------------------------------------------------------------------------------------------------------------------------------------------------
------------------------------------------------------------------------------------------------------------------------------------------------------
----------------------------------------------------------------------------------------------------------------------------------------------k-------
----------------------L------ooo-------------------------------------------------------------------------LL--------g-------------g----------g---------
-------LL-o--L---------------ooo--------------------------o----o-------------k-------------------------------------L---------LL--L--------LLL---------
----L-----o------------------ooo----------o---------------o----o------LL---g--------------LL-----------------L----------------------------------------
------L---o-------------------------------o-----------k--------o-----------LL-------o-------------------k-------L----LL-----L-----------L--------oo---
------------LTT--*---XXX---------L--------------*---g----------------L--------------o----L----*-------g-XXXX------XXX----------------o----XXXX-------g
----k--TT--g-TT--*---XXX-tt-XXXX---XXXX------k--*--tt-------tt---XXXX-tt------XXX---------tt--*-----XXXXXXXX------XXX--------tt-XXX--o----XXXX----k-tt
--g----TT-XX-TT--*---XXX-tt-XXXX---XXXX----g----*--tt----XX-tt--gXXXX-tt-XXXXXXXX---------tt--*-----XXXXXXXXXXX---XXX-----*--tt-XXX-------XXXX--g---tt
XXXXXXXXXXXXXXXXXXX--XXXXXXXXXXXXXXXXXX--XXXXXXXXXXXXX---XXXXXXXXXXXXXXXXXXXXXXXX--XXXX--XXXXXXXXXXXXXXXXXXXXXXXXXXXXXXXXXXXXXXXXXX-XXXXXXXXXXXXXXXXXX
XXXXXXXXXXXXXXXXXXX--XXXXXXXXXXXXXXXXXX--XXXXXXXXXXXXX---XXXXXXXXXXXXXXXXXXXXXXXX--XXXX--XXXXXXXXXXXXXXXXXXXXXXXXXXXXXXXXXXXXXXXXXX-XXXXXXXXXXXXXXXXXX
XXXXXXXXXXXXXXXXXXX--XXXXXXXXXXXXXXXXXX--XXXXXXXXXXXXX---XXXXXXXXXXXXXXXXXXXXXXXX--XXXX--XXXXXXXXXXXXXXXXXXXXXXXXXXXXXXXXXXXXXXXXXX-XXXXXXXXXXXXXXXXXX
XXXXXXXXXXXXXXXXXXX--XXXXXXXXXXXXXXXXXX--XXXXXXXXXXXXX---XXXXXXXXXXXXXXXXXXXXXXXX--XXXX--XXXXXXXXXXXXXXXXXXXXXXXXXXXXXXXXXXXXXXXXXX-XXXXXXXXXXXXXXXXXX
