M-----------------------------------------------------------------------------------------------------------------------------------------------------
------------------------------------------------------------------------------------------------------------------------------------------------------
------------------------------------------------------------------------------------------------------------------------------------------------------
------------------------------------------------------------------------------------------------------------------k-----------------------------------
----------------------------------------------------------------------------------------------------------------g-------------------------------------
-----------------oo---------------------------------------ooo---------o----------------------------------------LL-------------------------------------
-----------------oo---------------------oo--------------k-ooo--L---LL-o--------------------------o----------------------------------------------------
-----------------oo---------------------oo------------g---ooo---------o-----------LLL------------o--------k--------------------LL-----------------L---
--------------------o--------ook-------------------okLL-------L---k----------L--o-----LLL--------o------g--------------L----------L-------------------
---------------o-------------g----------tt--------g-------------g-XXXX-gXX------o-----------LL----------L------tt------------------------------------L
-------k*-------ktt---------tt-------*--tt-XXX---tt--------tt--tt-XXXXXXXXXXX---oXXXXX----------------k----tt--tt------------XXXXX--XX-----------tt---
-----g--*-----g--tt---XXXXX-tt-XXXXX-*--tt-XXXXX-tt--------tt--tt-XXXXXXXXXXX-g--XXXXX----------g---g------tt--tt------------XXXXXXXXX-----------tt---
XXXXXXXXXXXXXXXXXXXXXXXXXXXXXXXXXXXXXXXXXXXXXXXXXXXXXXXXXXXXXXXXXXXXXXXXXXXXXXXXXXXXXXXXXXXXXXXXXXXXXXXXXXXXXXXXXXXXXXXXXXXXXXXXXXXXXX---XXXXXXXXXXXXX
XXXXXXXXXXXXXXXXXXXXXXXXXXXXXXXXXXXXXXXXXXXXXXXXXXXXXXXXXXXXXXXXXXXXXXXXXXXXXXXXXXXXXXXXXXXXXXXXXXXXXXXXXXXXXXXXXXXXXXXXXXXXXXXXXXXXXX---XXXXXXXXXXXXX
XXXXXXXXXXXXXXXXXXXXXXXXXXXXXXXXXXXXXXXXXXXXXXXXXXXXXXXXXXXXXXXXXXXXXXXXXXXXXXXXXXXXXXXXXXXXXXXXXXXXXXXXXXXXXXXXXXXXXXXXXXXXXXXXXXXXXX---XXXXXXXXXXXXX
XXXXXXXXXXXXXXXXXXXXXXXXXXXXXXXXXXXXXXXXXXXXXXXXXXXXXXXXXXXXXXXXXXXXXXXXXXXXXXXXXXXXXXXXXXXXXXXXXXXXXXXXXXXXXXXXXXXXXXXXXXXXXXXXXXXXXX---XXXXXXXXXXXXX
