M-----------------------------------------------------------------------------------------------------------------------------------------------------
------------------------------------------------------------------------------------------------------------------------------------------------------
------------------------------------------------------------------------------------------------------------------------------------------------------
------------------------------------------------------------------------------------------------------------------------------------------------------
---o---------o----------------------------------------------------------------------------------------------------------------------------------------
---o---------o--------------------------------------------------------------------------------------------------------g-------------------------------
---o---------o---------------------------------------------LL--------LL-----------------------------------------------L------LL-----------------ooo---
----k----------L--------------------------------------------------------------------------------------------------k------o----------------------k---k-
--g----o------------------L--------------L----L------g----------------------------------------------------------g--------o--------------------g---g---
-tt-----------L-------------XXXX----tt-L---------tt-XXX----tt--------tt------o----------------L-XXXX-----------tt--------o-XXXXX-------------tt--tt---
-tt------o-tt--tt-----------XXXX----tt-----------tt-XXX-*--tt--------tt-oo---o------------TT----XXXX-tt----tt--tt----XXX---XXXXX------XXX----tt--tt---
-tt------g-tt--tt----XXXXX--XXXX-*--tt-----------tt-XXX-*--tt--------tt-------------------TT----XXXX-tt----tt--tt----XXX-g-XXXXX------XXX----tt--tt---
XXXXXXXXXXXXXXXXXX---XXXXXXXXXXXXXXXXXXXXXXXXXXXXXXXXXXXXXXXXX---XXXXXXXXXXXXXXXXXXXXXXXXXXXXXXXXXXXXXXX--XXXXXXXX---XXXXXXXXXXXXXXXX-XXX---XXXXXXXXXX
XXXXXXXXXXXXXXXXXX---XXXXXXXXXXXXXXXXXXXXXXXXXXXXXXXXXXXXXXXXX---XXXXXXXXXXXXXXXXXXXXXXXXXXXXXXXXXXXXXXX--XXXXXXXX---XXXXXXXXXXXXXXXX-XXX---XXXXXXXXXX
XXXXXXXXXXXXXXXXXX---XXXXXXXXXXXXXXXXXXXXXXXXXXXXXXXXXXXXXXXXX---XXXXXXXXXXXXXXXXXXXXXXXXXXXXXXXXXXXXXXX--XXXXXXXX---XXXXXXXXXXXXXXXX-XXX---XXXXXXXXXX
XXXXXXXXXXXXXXXXXX---XXXXXXXXXXXXXXXXXXXXXXXXXXXXXXXXXXXXXXXXX---XXXXXXXXXXXXXXXXXXXXXXXXXXXXXXXXXXXXXXX--XXXXXXXX---XXXXXXXXXXXXXXXX-XXX---XXXXXXXXXX
