M-----------------------------------------------------------------------------------------------------------------------------------------------------
------------------------------------------------------------------------------------------------------------------------------------------------------
------------------------------------------------------------------------------------------------------------------------------------------------------
------------------------------------------------------------------------------------------------------------------------------------------------------
------------------------------------------------------------------------------------------------------------------------------------------------------
-----------------------------------------------------k---------------------k--------------------------------------------------------------------------
---------g----oo------------------------------------g---------------------g--o------o---------------------------------------------------------!!------
--------oo----oo--------------LL-----o--------------oo---------------o----oo-o------o-----k---------------UU------------------------------------------
--------oo----oo--CC-----------------o--------------oo---------------o-k--oo-o-----oo-k--g-----------k---g-------UUU--------k-----oo------------------
--------XXX---XXX--------------------o----------*---oo--------------o-g-XXXXXXXXX--o-g-XXXXX--------g----o----------XX-----g------oo---------!tt------
XXXXXXXXXXX---XXX----------XXXXX------------tt--*------------o---XXXott-XXXXXXXXXXXott-XXXXX-------tt-XX-----TT-----XX---XXXX----------o------tt-XXXXX
XXXXXXXXXXX---XXX---------gXXXXX------------tt--*-XXXX-------o---XXX-tt-XXXXXXXXXXX-tt-XXXXX-------tt-XXXXXX-TT-XXXXXX---XXXXXXXXX------------tt-XXXXX
XXXXXXXXXXXXXXXXXXXXXX---XXXXXXXXXXXXXXXXXXXXXXXXXXXXXXXXX---XXXXXXXXXXXXXXXXXXXXXXXXXXXXXXX---XXXXXXXXXXXXXXXXXXXXXXX---XXXXXXXXXXXXXXXXXXXXXXXXXXXXX
XXXXXXXXXXXXXXXXXXXXXX---XXXXXXXXXXXXXXXXXXXXXXXXXXXXXXXXX---XXXXXXXXXXXXXXXXXXXXXXXXXXXXXXX---XXXXXXXXXXXXXXXXXXXXXXX---XXXXXXXXXXXXXXXXXXXXXXXXXXXXX
XXXXXXXXXXXXXXXXXXXXXX---XXXXXXXXXXXXXXXXXXXXXXXXXXXXXXXXX---XXXXXXXXXXXXXXXXXXXXXXXXXXXXXXX---XXXXXXXXXXXXXXXXXXXXXXX---XXXXXXXXXXXXXXXXXXXXXXXXXXXXX
XXXXXXXXXXXXXXXXXXXXXX---XXXXXXXXXXXXXXXXXXXXXXXXXXXXXXXXX---XXXXXXXXXXXXXXXXXXXXXXXXXXXXXXX---XXXXXXXXXXXXXXXXXXXXXXX---XXXXXXXXXXXXXXXXXXXXXXXXXXXXX
