M-----------------------------------------------------------------------------------------------------------------------------------------------------
------------------------------------------------------------------------------------------------------------------------------------------------------
------------------------------------------------------------------------------------------------------------------------------------------------------
-----------------------------------------------------------------------------------------------------------------------k------------------------------
-----------------------------------------------------L---------------------------------------------------------------g--------------------------------
-----------------------------------------oo--------------------------------------------------o----------------------LL--------------------oo----------
-------------L-------------------------L-oo--ooo------L-----------L---------LL---------------o----------------L-------------LL------------oo----------
----L-----------LL-------------o---------oo--ooo---------------------------k------------------------------ooo---LL------------------o-----------k-----
-------------------------------o-------------ooo-----k-----oo------------g--------------oooo--------o-----ooo------L-------k--------o---------g--o----
-------------------------------o--tt-XXXX-tt-------g----------o--tt-----tt--tt--*-------oook--------o-----ooo-------tt---g------tt-----------tt------o
---tt--------XXXXXXX------*-------tt-XXXX-tt--tt--tt-XXXX--------tt-----tt--tt--*-----k--g---tt--tt-----o-k---XXXXX-tt--tt--tt--tt----*--tt--tt-------
---tt--g-----XXXXXXX------*-------tt-XXXX-tt--tt--tt-XXXX-----XX-tt--*--tt--tt--*---g--XXXXX-tt--tt-----g-----XXXXX-tt--tt--tt--tt----*--tt--tt-XXXX-g
XXXXXXXXX-XX-XXXXXXXXXXXXXXX---XXXXXXXXXXXXXXXXXXXXXXXXXX--XXXXXXXXXXXXXXXXXXXXXXXXXXXXXXXXXXXXXXXXXXXXXXXXXXXXXXXXXXXXXXXXXXXXXXXXXXXXXXXXXXXXXXXXXXX
XXXXXXXXX-XX-XXXXXXXXXXXXXXX---XXXXXXXXXXXXXXXXXXXXXXXXXX--XXXXXXXXXXXXXXXXXXXXXXXXXXXXXXXXXXXXXXXXXXXXXXXXXXXXXXXXXXXXXXXXXXXXXXXXXXXXXXXXXXXXXXXXXXX
XXXXXXXXX-XX-XXXXXXXXXXXXXXX---XXXXXXXXXXXXXXXXXXXXXXXXXX--XXXXXXXXXXXXXXXXXXXXXXXXXXXXXXXXXXXXXXXXXXXXXXXXXXXXXXXXXXXXXXXXXXXXXXXXXXXXXXXXXXXXXXXXXXX
XXXXXXXXX-XX-XXXXXXXXXXXXXXX---XXXXXXXXXXXXXXXXXXXXXXXXXX--XXXXXXXXXXXXXXXXXXXXXXXXXXXXXXXXXXXXXXXXXXXXXXXXXXXXXXXXXXXXXXXXXXXXXXXXXXXXXXXXXXXXXXXXXXX
