M-----------------------------------------------------------------------------------------------------------------------------------------------------
------------------------------------------------------------------------------------------------------------------------------------------------------
------------------------------------------------------------------------------------------------------------------------------------------------------
------------------------------k-----------------------------------------------------------------------------------------------------------------------
----------------------------g-------------------------------------------------------------------------------------------------------------------------
-------------LL------------LL-------------------ooo------------LL-------------------------------------------------------------------------------------
------------------------------------------------ooo---------------------------o------------------oo---------------------------LL-------L-------LL-----
o------------------------------oo----L-----k----------------------------------o------------------------------------------------------k------------o--L
o---------L--------------k---------------g--------------------L---------------ok--o-----------------k----------------oo----L-------g--------------o---
o-----------XXXX-------g---tt-----tt----tt------tt-------------tt------------g--------------------g---------------tt---------XXXXXXXXXXXX----k--------
----k-------XXXX-----XXXXX-tt-----tt--g-tt------tt-------------tt-----------tt------tt-----------TT-----*------o--tt---------XXXXXXXXXXXX--g---tt----t
--g---------XXXX----gXXXXX-tt-XXX-tt-XX-tt------tt--g----------tt--------g--tt------tt-----------TT-----*--g------tt--------gXXXXXXXXXXXXXXXXX-tt--g-t
XXXXXXX---XXXXXX---XXXXXXXXXXXXXXXXXXXXXXXX----XXXXXXXXXXXX---XXXX---XXXXXXXXXX--XXXXXX--XXXX---XXXX---XXXXXX--XXXXXXXXXXXXXXXXXXXXXXXXXXXXXXXXXXXXXXX
XXXXXXX---XXXXXX---XXXXXXXXXXXXXXXXXXXXXXXX----XXXXXXXXXXXX---XXXX---XXXXXXXXXX--XXXXXX--XXXX---XXXX---XXXXXX--XXXXXXXXXXXXXXXXXXXXXXXXXXXXXXXXXXXXXXX
XXXXXXX---XXXXXX---XXXXXXXXXXXXXXXXXXXXXXXX----XXXXXXXXXXXX---XXXX---XXXXXXXXXX--XXXXXX--XXXX---XXXX---XXXXXX--XXXXXXXXXXXXXXXXXXXXXXXXXXXXXXXXXXXXXXX
XXXXXXX---XXXXXX---XXXXXXXXXXXXXXXXXXXXXXXX----XXXXXXXXXXXX---XXXX---XXXXXXXXXX--XXXXXX--XXXX---XXXX---XXXXXX--XXXXXXXXXXXXXXXXXXXXXXXXXXXXXXXXXXXXXXX
