M-----------------------------------------------------------------------------------------------------------------------------------------------------
------------------------------------------------------------------------------------------------------------------------------------------------------
------------------------------------------------------------------------------------------------------------------------------------------------------
----------------------------k-------------------------------------------------------------------------------------------------------------------------
--------------------------g-----------------L------------------------------------------------oo----------------------------------------L--------------
--------------------------L---------------------------oo-------------------------------------oo-------------------------------LLL-------L--LL---------
----------------LLL-----------------------------------oo----------oo-------------------------oo----------k--------------------------------------------
---------------------LL-------L---------------------L-------------ook-------------kooo-----------------g---LL-----------------------------------------
--------------------------------------------k---------------------g-------------g--ooo----L-----------LL-------------------------------k--------------
----------------XXXXL----TT---------------g---L---------------XX-tt---ooo---L--tt------------tt-----------------L-------------XXXXX--g-XXXXXXX-----o--
XXXXX-------k---XXXX-tt--TT--tt--------k-tt------o--k-XXXX-tt-XX-tt-o-ooo------tt-----ktt----tt----------XXXXX-----oo--------kXXXXX-TT-XXXXXXX--------
XXXXX-XX--g-----XXXX-tt--TT--tt------g---tt--g----g---XXXX-tt-XX-tt------------tt---g--tt--g-tt------XXXXXXXXX-g---g-------g--XXXXX-TT-XXXXXXX--------
XXXXX-XXXXXXX---XXXXXXXXXXXXXXXX-XXXXXXXXXXXXXXXXXXXXXXXXXXXXXXXXXXXXXXXXXXXXXXXXXXXXXXXXXXXXXXXXXXXXXXXXXXXXXXXXXXXXXXXXXXXXXXXXXXXXXXXXXXXXX----XXXX
XXXXX-XXXXXXX---XXXXXXXXXXXXXXXX-XXXXXXXXXXXXXXXXXXXXXXXXXXXXXXXXXXXXXXXXXXXXXXXXXXXXXXXXXXXXXXXXXXXXXXXXXXXXXXXXXXXXXXXXXXXXXXXXXXXXXXXXXXXXX----XXXX
XXXXX-XXXXXXX---XXXXXXXXXXXXXXXX-XXXXXXXXXXXXXXXXXXXXXXXXXXXXXXXXXXXXXXXXXXXXXXXXXXXXXXXXXXXXXXXXXXXXXXXXXXXXXXXXXXXXXXXXXXXXXXXXXXXXXXXXXXXXX----XXXX
XXXXX-XXXXXXX---XXXXXXXXXXXXXXXX-XXXXXXXXXXXXXXXXXXXXXXXXXXXXXXXXXXXXXXXXXXXXXXXXXXXXXXXXXXXXXXXXXXXXXXXXXXXXXXXXXXXXXXXXXXXXXXXXXXXXXXXXXXXXX----XXXX
