M-----------------------------------------------------------------------------------------------------------------------------------------------------
------------------------------------------------------------------------------------------------------------------------------------------------------
------------------------------------------------------------------------------------------------------------------------------------------------------
------------------------------------------------------------------------------------------------------------------------------------------------------
--------------------------------------------------------------------------------------------------oo--------------------------------------------------
---------Lg------------L-------oo---------------o----------------L--------------------------------oo---LL--------------oo------L----------------------
------o---L-L------------------oo---------------o-----------------------------------------oo------oo-------------------oo------------------------o----
-------------------ooo---------oo--L------------o---------o------------------------L------oo-----------------------------------------------L-----o--oo
---------k----ooo--ooo-k-LLL------------------------------o------k-----ooLL--oooL-----k---oo--------------------------------------LL-o-----------o--oo
-*-----g-XXXXXooo----g--------XXX------------------------------g------------------L-g-o----------------tt-LLL--tt------tt---o-TT--------------------oo
-*---XXXXXXXXX------tt-XX-----XXX-tt--------------------------tt------tt-----tt----tt--------------tt--tt------tt--tt--tt-----TT--------tt------------
-*--gXXXXXXXXX------tt-XX-----XXX-tt--*---------XX------------tt------tt-XXX-tt--g-tt-XX---g-XXXXX-tt--tt------tt--tt--tt-----TT--------tt-XX---XXX---
XXXXXXXXXXXXXXXXXXXXXXXXXXXXXXXXXXXXXXXX---XXX--XX--XXXXXXX--XXXXXX--XXXXXXXXXXXXXXXXXXX--XXXXXXXXXXXXXXXXXXXXXXXXXXXXXXXXXXXXXXXXXXXXXXXXXXX---XXXXXX
XXXXXXXXXXXXXXXXXXXXXXXXXXXXXXXXXXXXXXXX---XXX--XX--XXXXXXX--XXXXXX--XXXXXXXXXXXXXXXXXXX--XXXXXXXXXXXXXXXXXXXXXXXXXXXXXXXXXXXXXXXXXXXXXXXXXXX---XXXXXX
XXXXXXXXXXXXXXXXXXXXXXXXXXXXXXXXXXXXXXXX---XXX--XX--XXXXXXX--XXXXXX--XXXXXXXXXXXXXXXXXXX--XXXXXXXXXXXXXXXXXXXXXXXXXXXXXXXXXXXXXXXXXXXXXXXXXXX---XXXXXX
XXXXXXXXXXXXXXXXXXXXXXXXXXXXXXXXXXXXXXXX---XXX--XX--XXXXXXX--XXXXXX--XXXXXXXXXXXXXXXXXXX--XXXXXXXXXXXXXXXXXXXXXXXXXXXXXXXXXXXXXXXXXXXXXXXXXXX---XXXXXX
