M-----------------------------------------------------------------------------------------------------------------------------------------------------
------------------------------------------------------------------------------------------------------------------------------------------------------
------------------------------------------------------------------------------------------------------------------------------------------------------
------------------------------------------------------------------------------------------------------------------------------------------------------
------------------------------------------------------------------k------------oo------------------------------------------L---------ooo--------------
------------L---------------------ooo---------------------------g--------------oo-------------------------------------------LL-------ooo--------------
----------------------------------ooo---LL--LL----------o-LLL--LL-------------------------------------o------------------------------ooo-------L------
-o--L--------LL------------oo-------------------o--ooo--o---------o------------------ooo--------------o----LL----------------------o----k-------------
-o----------k--------------oo---------k-----------------o-----L---o---------------L--ooo------L-------o--------------g-----k-------o--g---------------
-----LL---g-------------------------g-XXXXXLtt--tt-XXXX--XXXXX----------------tt-----ooo--LL------------k-----------LL---g--tt------XXXX----XXXXX-----
----k----tt--TT-----------tt-------tt-XXXXX-tt--tt-XXXXXXXXXXX-TT---------XXX-tt--------k--------tt---g--XXXXX----------TT--tt------XXXX-tt-XXXXX-tt--
--g------tt--TT-----------tt----XX-tt-XXXXX-tt--tt-XXXXXXXXXXX-TT--g------XXX-tt---g--g----------tt-XXXXXXXXXX-*--*-----TT--tt----g-XXXX-tt-XXXXX-tt-X
XXXXXXXXXXXXXXXXXX----XXXXXXXXXXXXXXXXXXXXXXXXXXXXXXXXXXXXXXXXXXXXXXX-XXX-XXXXXXX-XXXXXXXXXXXXXXXXXXXXXXXXXXXXXXXXXXXXXXXXXXXXX--XXXXXXXXXXXXXXXXXXXXX
XXXXXXXXXXXXXXXXXX----XXXXXXXXXXXXXXXXXXXXXXXXXXXXXXXXXXXXXXXXXXXXXXX-XXX-XXXXXXX-XXXXXXXXXXXXXXXXXXXXXXXXXXXXXXXXXXXXXXXXXXXXX--XXXXXXXXXXXXXXXXXXXXX
XXXXXXXXXXXXXXXXXX----XXXXXXXXXXXXXXXXXXXXXXXXXXXXXXXXXXXXXXXXXXXXXXX-XXX-XXXXXXX-XXXXXXXXXXXXXXXXXXXXXXXXXXXXXXXXXXXXXXXXXXXXX--XXXXXXXXXXXXXXXXXXXXX
XXXXXXXXXXXXXXXXXX----XXXXXXXXXXXXXXXXXXXXXXXXXXXXXXXXXXXXXXXXXXXXXXX-XXX-XXXXXXX-XXXXXXXXXXXXXXXXXXXXXXXXXXXXXXXXXXXXXXXXXXXXX--XXXXXXXXXXXXXXXXXXXXX
