M-----------------------------------------------------------------------------------------------------------------------------------------------------
------------------------------------------------------------------------------------------------------------------------------------------------------
------------------------------------------------------------------------------------------------------------------------------------------------------
-----------------------------------------------------------------------------g------------------------------------------------------------------------
-----------------------------------------------------------------------------o------------------------------------------------------------------------
-----------------------------------------------------------------------------o----------------------------------------------------o-------------------
---------------@@----------------------o-------------------------------------o------------------ooo------------o------------------o-------------------
----ooo------------------------------------g---g-oo-----CC---------g----------------------------ooo------------o------------------oo------------------
-S--ooo---------------------------------g-oo---o-oo---------------oo------------------UU-----------------------o-------------------o----------ooo---g-
----ooo!!-----------------------XXXXX@@XX-tt---oooo---------------oo--------TT-o----*------o---XXXXX-----o---g---------------------o----XXX---ooo--oo-
-----------TT-XXXXX--------o----XXXXX--XX-tt--XXott--*--tt----oo-ott--------TT--tt--*------o-o-XXXXX---k-XX-tto------------------tt-----XXX---ooo--oo-
-----------TT-XXXXX-----g-g-----XXXXX--XX-tto-XXott--*--tt----oo-ott-----XX-TT--tt--*---XXXXX-gXXXXX--g--XX-tt-XXX---------------tt-----XXX--------XXX
XXXXXXXXX-XXXXXXXXX----XXXXXXXXXXXXXXXXXXXXXX-XXXXXXXXXXXXX---XXXXXXX----XXXXXXXXXXXXXXXXXXXXXXXXXXXXXXXXXXXXXXXXX----XXXXXXXXXXXXXXXXXXXXXXXXXXXXXXXX
XXXXXXXXX-XXXXXXXXX----XXXXXXXXXXXXXXXXXXXXXX-XXXXXXXXXXXXX---XXXXXXX----XXXXXXXXXXXXXXXXXXXXXXXXXXXXXXXXXXXXXXXXX----XXXXXXXXXXXXXXXXXXXXXXXXXXXXXXXX
XXXXXXXXX-XXXXXXXXX----XXXXXXXXXXXXXXXXXXXXXX-XXXXXXXXXXXXX---XXXXXXX----XXXXXXXXXXXXXXXXXXXXXXXXXXXXXXXXXXXXXXXXX----XXXXXXXXXXXXXXXXXXXXXXXXXXXXXXXX
XXXXXXXXX-XXXXXXXXX----XXXXXXXXXXXXXXXXXXXXXX-XXXXXXXXXXXXX---XXXXXXX----XXXXXXXXXXXXXXXXXXXXXXXXXXXXXXXXXXXXXXXXX----XXXXXXXXXXXXXXXXXXXXXXXXXXXXXXXX
