M-----------------------------------------------------------------------------------------------------------------------------------------------------
------------------------------------------------------------------------------------------------------------------------------------------------------
------------------------------------------------------------------------------------------------------------------------------------------------------
---------------------------------oo-------------------------------------------------------------------------------------------------------------------
---------------------------------oo-----------------------------------------------------------L-------k------L----------------------------------------
---------------------L----------koo-----------------------------------------------------------------g--L-----------------LL---------------------------
-ooo-----o--------------------g----------------------------------------------------oo---L---o------LL---------------LL--------------------------------
----ooo--o------k-----------LLL------------LL------------------------------------k----k-----o----o---------o-k---------------L------------------------
--g-ooo-k-----g-----------L---------------------LL-----------------------kLL---g----g-------o-k--o---------g--g-----------------k----------LL---------
-TT---g--tt---LL-LL--XX-o-------XXXXX--------------LL----------*-------g-------LL-XXXXXXXX--g-XX---TT-XXX-tt--L--tt-XXXX-tt-L-g-----------------------
-TT--tt--tt----------XX---------XXXXX------tt------------------*-----XXXX---------XXXXXXXX-tt-XX---TT-XXX-tt-----tt-XXXX-tt--tt-----XXXX--------------
-TT--tt--tt--------g-XX-g---XXXXXXXXX------tt------------------*---g-XXXX---------XXXXXXXX-tt-XX---TT-XXX-tt-----tt-XXXX-tt--tt-----XXXX---------XXX--
XXXXXXXXXXXXXXXXXXXXXXXXXXXXXXXXXXXXXXXXXXXXXXXXXXXXXXXXXXX---XXXXXXXXXXXXXXXXXXXXXXXXXXXXXXXXXXXXXXXXXXXXXXXXXXXXXXXXXXXXXXXXXXXXXXXXXXXXXXXX---XXXXX
XXXXXXXXXXXXXXXXXXXXXXXXXXXXXXXXXXXXXXXXXXXXXXXXXXXXXXXXXXX---XXXXXXXXXXXXXXXXXXXXXXXXXXXXXXXXXXXXXXXXXXXXXXXXXXXXXXXXXXXXXXXXXXXXXXXXXXXXXXXX---XXXXX
XXXXXXXXXXXXXXXXXXXXXXXXXXXXXXXXXXXXXXXXXXXXXXXXXXXXXXXXXXX---XXXXXXXXXXXXXXXXXXXXXXXXXXXXXXXXXXXXXXXXXXXXXXXXXXXXXXXXXXXXXXXXXXXXXXXXXXXXXXXX---XXXXX
XXXXXXXXXXXXXXXXXXXXXXXXXXXXXXXXXXXXXXXXXXXXXXXXXXXXXXXXXXX---XXXXXXXXXXXXXXXXXXXXXXXXXXXXXXXXXXXXXXXXXXXXXXXXXXXXXXXXXXXXXXXXXXXXXXXXXXXXXXXX---XXXXX
