M-----------------------------------------------------------------------------------------------------------------------------------------------------
------------------------------------------------------------------------------------------------------------------------------------------------------
------------------------------------------------------------------------------------------------------------------------------------------------------
------------------------------------------------------------------------------------k-----------------------------------------------------------------
-------------------------------------------------------L--------------------------g-------------------------------------------------------------------
------------------------------------LLL------------------------------------------LL---------------------LL--LL-----------------oo--------L------------
--------------L--LL---------------------------------o------------L-------------------LL----------------------------------------oo----ooo--------------
------------k------------------------------------------k---------------------------------------o-------------------------------------ooo--------------
o---------g------------------------------g-----------g-------------------------------------ook-o----------------------L-----k------o-ooo--------------
o-----*--tt--tt-Ltt----------------XXXXXLL--L-------tt-------------------g-------tt--tt----g---o-----L--tt-XXXXX---L------g--XXXX--------XX------L--tt
------*--tt--tt--tt------g---------XXXXX----------k-tt-XX------ktt------XXX------tt--tt---tt-----tt-----tt-XXXXX--------XXXXXXXXX-tt-XXXXXX-*-------tt
XX----*--tt--tt--tt-----XXX------g-XXXXX--------g---tt-XX-g--g--tt------XXX------tt--tt---tt-----tt-----tt-XXXXX--------XXXXXXXXX-tt-XXXXXX-*-------tt
XX---XXXXXXXXXXXXXXXXXXXXXXXXX-XXXXXXXXXXXXXXXXXXXXXXXXXXXXXXXXXXXXXXXXXXXXXXXXXXXXXXXXX-XXXXXXXXXXXXXXXXXXXXXXXXXXXXXXXXXXXXXXXXXXXXXXXXXXXXXXXXXXXXX
XX---XXXXXXXXXXXXXXXXXXXXXXXXX-XXXXXXXXXXXXXXXXXXXXXXXXXXXXXXXXXXXXXXXXXXXXXXXXXXXXXXXXX-XXXXXXXXXXXXXXXXXXXXXXXXXXXXXXXXXXXXXXXXXXXXXXXXXXXXXXXXXXXXX
XX---XXXXXXXXXXXXXXXXXXXXXXXXX-XXXXXXXXXXXXXXXXXXXXXXXXXXXXXXXXXXXXXXXXXXXXXXXXXXXXXXXXX-XXXXXXXXXXXXXXXXXXXXXXXXXXXXXXXXXXXXXXXXXXXXXXXXXXXXXXXXXXXXX
XX---XXXXXXXXXXXXXXXXXXXXXXXXX-XXXXXXXXXXXXXXXXXXXXXXXXXXXXXXXXXXXXXXXXXXXXXXXXXXXXXXXXX-XXXXXXXXXXXXXXXXXXXXXXXXXXXXXXXXXXXXXXXXXXXXXXXXXXXXXXXXXXXXX
