M-----------------------------------------------------------------------------------------------------------------------------------------------------
------------------------------------------------------------------------------------------------------------------------------------------------------
------------------------------------------------------------------------------------------------------------------------------------------------------
--------------------------------------------------------------------------------------------------------------------------------------------------o---
-------------------------------------------------------------------------------------------------------------------------------------------L------oL--
-----------------------------------LL-------------LL-----------------oo-----------------------------------------------------------------oo--------o---
-----------------------------k------------------------------------o--oo--------------------ooo-------------oo---------LLL------------o--oo--L---------
----------------------LL---g--------------------------------------o--oo-----k------------------ooo---------ook------k-------------------oo-k-------k--
-g-------LL--------------LLL--------------------------------------o-------g--------------------ooo--o------g------g----------------------g-------g----
XX--LL----------------------------XXXX----------XXXXX---------tt-----XXX-tt-------o----------g------o-----tt-----tt----------------L----tt--tt--tt--LL
XX------------------XXXXX--------kXXXX-------k--XXXXX----ktt--tt-XXXXXXX-tt-------------o-k-tt------------tt-----tt---XXXX-tt-----k--XX-tt--tt--tt----
XX-----XXXXXXXXX----XXXXXXXXX--g--XXXX-----g----XXXXX--g--tt--tt-XXXXXXX-tt-------g-----g---tt------------tt-----tt---XXXX-tt---g----XX-tt--tt--tt----
XXXXXXXXXXXXXXXX----XXXXXXXXXXXXXXXXXXXXXXXXXXXXXXXXXXXXXXXXXXXXXXXXXXXXXXXX-XXX-XXXXXXXXXXXXXXXXXXXXXXXXXXXX---XXXX--XXXXXXXXXXXXXXXXXXXXXXXXXXXXXXXX
XXXXXXXXXXXXXXXX----XXXXXXXXXXXXXXXXXXXXXXXXXXXXXXXXXXXXXXXXXXXXXXXXXXXXXXXX-XXX-XXXXXXXXXXXXXXXXXXXXXXXXXXXX---XXXX--XXXXXXXXXXXXXXXXXXXXXXXXXXXXXXXX
XXXXXXXXXXXXXXXX----XXXXXXXXXXXXXXXXXXXXXXXXXXXXXXXXXXXXXXXXXXXXXXXXXXXXXXXX-XXX-XXXXXXXXXXXXXXXXXXXXXXXXXXXX---XXXX--XXXXXXXXXXXXXXXXXXXXXXXXXXXXXXXX
XXXXXXXXXXXXXXXX----XXXXXXXXXXXXXXXXXXXXXXXXXXXXXXXXXXXXXXXXXXXXXXXXXXXXXXXX-XXX-XXXXXXXXXXXXXXXXXXXXXXXXXXXX---XXXX--XXXXXXXXXXXXXXXXXXXXXXXXXXXXXXXX
