M-----------------------------------------------------------------------------------------------------------------------------------------------------
------------------------------------------------------------------------------------------------------------------------------------------------------
------------------------------------------------------------------------------------------------------------------------------------------------------
------------------------------------------------------------------------------------------------------------------------------------------------------
------------------------------------------------------------------------------------------------------------------------------------------------------
-----g-----------g-------------------------------------------g--------------------------------------------------------------------------------oo------
----oo----------UUU-------------------------g------UU----@@--o-----------------------------g------------o--------g----k--oooo-----------------oo----o-
----oo--------------g-----------------------o---------------------o------------------------o------------o-------LLL--g------------------------oo----o-
---ooo-------------!!----------------o------o--------------@------o-----------------------------------g------------oooo---------g--------ooo--------o-
-g-o-----------XXXX-----g---k--------o------o---o-----------XX----o----------------------XXXX---------o-tt---------oooo-XXXXX--tt--------ooo----------
XX-ott-------g-XXXX-----o--g----o---XXXXX----------XXXXX-TT-XX-tt--tt-XXXX------------XXXXXXX---*-----o-tt-oo------oooo-XXXXX--tt------*-XXXXXXXXXXXXX
XX--tt------oo-XXXXXXX-XXXXXXX-go---XXXXXog--------XXXXX-TT-XX-tt--tt-XXXX-------XXXXXXXXXXXX---*-------tt-oog-XXXX-----XXXXX--tt------*-XXXXXXXXXXXXX
XX-XXXX--XXXXXXXXXXXXX-XXXXXXXXXX---XXXXXXXXXXXXXX-XXXXXXXXXXXXXXXXXXXXXXXXXXXX--XXXXXXXXXXXX--XXXXXXXXXXXXXXXXXXXXXXXXXXXXXX-XXXX----XXXXXXXXXXXXXXXX
XX-XXXX--XXXXXXXXXXXXX-XXXXXXXXXX---XXXXXXXXXXXXXX-XXXXXXXXXXXXXXXXXXXXXXXXXXXX--XXXXXXXXXXXX--XXXXXXXXXXXXXXXXXXXXXXXXXXXXXX-XXXX----XXXXXXXXXXXXXXXX
XX-XXXX--XXXXXXXXXXXXX-XXXXXXXXXX---XXXXXXXXXXXXXX-XXXXXXXXXXXXXXXXXXXXXXXXXXXX--XXXXXXXXXXXX--XXXXXXXXXXXXXXXXXXXXXXXXXXXXXX-XXXX----XXXXXXXXXXXXXXXX
XX-XXXX--XXXXXXXXXXXXX-XXXXXXXXXX---XXXXXXXXXXXXXX-XXXXXXXXXXXXXXXXXXXXXXXXXXXX--XXXXXXXXXXXX--XXXXXXXXXXXXXXXXXXXXXXXXXXXXXX-XXXX----XXXXXXXXXXXXXXXX
