M-----------------------------------------------------------------------------------------------------------------------------------------------------
------------------------------------------------------------------------------------------------------------------------------------------------------
------------------------------------------------------------------------------------------------------------------------------------------------------
-----------------------------------------------------------------------------------------------------------------------------------------------------L
----k---------------------------------------------------------------------------------oo--------------------------------------------------------------
--g---------------LL-------------oo---------------------------------------------------oo----ooo-------------------------------------------------------
-LL------------------------------oo-------LLL-------------LL--------LL---------o------oo----ooo---------------------------------LL--------------------
----oooo----------------------------L----------LL--------------LLL-------------o------------ooo------------oo-----------L----------------L----LL-----k
----oooo------oo-----L----ooo----------------------------L-----------------LL--o-----------------------------k------L------------------------------g--
----oooo----------tt----XX------tt--------XXXXL-----L---------------tt------------tt--tt-----tt----*----o--g--tt----------------------------------tt--
-tt-------tt-----ktt----XX----k-tt-XXX----XXXX-tt---------tt---XXXX-tt------------tt--tt-----tt----*------tt--tt--*-----------k-tt-----ktt----tt--tt--
-tt-------tt---g--tt----XX--g---tt-XXX--g-XXXX-tt---------tt---XXXX-tt-----XXXXXX-tt--tt-----tt----*------tt--tt--*---XXXX--g---tt---g--tt----tt--tt--
XXXXXXXXXXXXXXXXXXXXXXX-XXXXXXXXXXXXXXXXXXXXXXXXXXXXXX---XXXX--XXXXXXXXXXXXXXXXXXXXXXXXXX---XXXXXXXXXXXXXXXXXXXXXXXXXXXXXXXXXXXXXXXXXXXXXXX--XXXXXXXXX
XXXXXXXXXXXXXXXXXXXXXXX-XXXXXXXXXXXXXXXXXXXXXXXXXXXXXX---XXXX--XXXXXXXXXXXXXXXXXXXXXXXXXX---XXXXXXXXXXXXXXXXXXXXXXXXXXXXXXXXXXXXXXXXXXXXXXX--XXXXXXXXX
XXXXXXXXXXXXXXXXXXXXXXX-XXXXXXXXXXXXXXXXXXXXXXXXXXXXXX---XXXX--XXXXXXXXXXXXXXXXXXXXXXXXXX---XXXXXXXXXXXXXXXXXXXXXXXXXXXXXXXXXXXXXXXXXXXXXXX--XXXXXXXXX
XXXXXXXXXXXXXXXXXXXXXXX-XXXXXXXXXXXXXXXXXXXXXXXXXXXXXX---XXXX--XXXXXXXXXXXXXXXXXXXXXXXXXX---XXXXXXXXXXXXXXXXXXXXXXXXXXXXXXXXXXXXXXXXXXXXXXX--XXXXXXXXX
