M-----------------------------------------------------------------------------------------------------------------------------------------------------
------------------------------------------------------------------------------------------------------------------------------------------------------
------------------------------------------------------------------------------------------------------------------------------------------------------
--------------------------------------------k---------------------------------------------------------------------------------------k-----------------
----L-------------------------------------g-----------------------------------------------------L---------------------------------g-----o-------------
-----------------------------------------LL--------------------------------------------------------------------------------------LL-----o----L--------
---------ooo--------------------------o--------------------------------------o----o------LL---------------LL----------------------------o-------------
oo-------ooo--------------------------o------LL--------------------------------k--o-ooo-----------LLL-oo--------------------------------------------o-
----kL---ooo---------------L----------o-L---------LL------------k------------g----g-ooo---------k-----oo---------------o--------L------------k--------
--g--------------------tt-----o----------tt-------------------g-----k---tt-XXXXX-tt-ooo--tt---g-------oo-Ltt---LL-------o----tt--tt--------g----g----k
-tt----------XX-g------tt-----o----------tt--tt--------tt----tt---g--*--tt-XXXXX-tt-----ktt--tt---XXXX----tt----------k-o----tt--tt-XXXXXXXXX--XX--g--
-tt-----gXXXXXXXXXXX---tt----------------tt--tt--------tt--g-tt-XXXX-*--tt-XXXXX-tt---g--tt--tt---XXXX-g--tt--------g--------tt--tt-XXXXXXXXX-gXXXXXX-
XXXXXXXXXXXXXXXXXXXX--XXXXXXXXXXX---XXX-XXXXXXXX--XXXXXXXXXXXXXXXXXXXXXXXXXXXXXXXXXXXXXXXXXXXXXXXXXXXXXXXXXXXXXXXXXXXXXXXXXXXXXXXXXXXXXXXXXXXXXXXXXXXX
XXXXXXXXXXXXXXXXXXXX--XXXXXXXXXXX---XXX-XXXXXXXX--XXXXXXXXXXXXXXXXXXXXXXXXXXXXXXXXXXXXXXXXXXXXXXXXXXXXXXXXXXXXXXXXXXXXXXXXXXXXXXXXXXXXXXXXXXXXXXXXXXXX
XXXXXXXXXXXXXXXXXXXX--XXXXXXXXXXX---XXX-XXXXXXXX--XXXXXXXXXXXXXXXXXXXXXXXXXXXXXXXXXXXXXXXXXXXXXXXXXXXXXXXXXXXXXXXXXXXXXXXXXXXXXXXXXXXXXXXXXXXXXXXXXXXX
XXXXXXXXXXXXXXXXXXXX--XXXXXXXXXXX---XXX-XXXXXXXX--XXXXXXXXXXXXXXXXXXXXXXXXXXXXXXXXXXXXXXXXXXXXXXXXXXXXXXXXXXXXXXXXXXXXXXXXXXXXXXXXXXXXXXXXXXXXXXXXXXXX
