M-----------------------------------------------------------------------------------------------------------------------------------------------------
------------------------------------------------------------------------------------------------------------------------------------------------------
------------------------------------------------------------------------------------------------------------------------------------------------------
------------------------------------------------------------------------------------------------------------------------------------------------------
-----------------------ooo---------------------------------o------------------------------------------------------------------------------------------
-----------------------ooo---------------------------------o-LL-----------------------------------L----------------------------------------------k----
---LL--oo----------LL-----------L----------------o---------o-----LL-----------------------------------------------oooo------LL--LL-------------g------
-------oo----k----------------------------------------------------------------------------------------------------oooo-----k------------------LL------
-------oo--g-------------------------------LL---g-----------L------------------o------------k----L------L----LLL--oooo---g-----------------o------LL--
---tt----XXXXX---XXXXXXXXXX----tt---------o----XXX--LL--XXXX-tt--tt-----tt--L-------------g-------tt--------------------tt-----Ltt-----------L-------X
---tt--g-XXXXX---XXXXXXXXXXXXX-tt--------------XXX------XXXX-tt--tt-----tt-------tt-----XXXXX-tt--tt--*-----------------tt--tt--tt--tt--tt----tt-----X
---tt-XXXXXXXX-g-XXXXXXXXXXXXX-tt------------g-XXX------XXXX-tt--tt-----tt-----g-tt-----XXXXX-tt--tt--*--g--------XXXXX-tt--tt--tt--tt--tt----tt-----X
XXXXXXXXXXXXXXXXXXXXXXXXXXXXXXXXXXXX---XXXXXXXXXXX-XXXXXXXXXXXXXXXXX---XXXXXXXXXXXXXXXXXXXXXXXXXXXXXXXXXXX---XXXXXXXXXXXXXXXXXXXXXXXXXXXXXXXXXXXXXXXXX
XXXXXXXXXXXXXXXXXXXXXXXXXXXXXXXXXXXX---XXXXXXXXXXX-XXXXXXXXXXXXXXXXX---XXXXXXXXXXXXXXXXXXXXXXXXXXXXXXXXXXX---XXXXXXXXXXXXXXXXXXXXXXXXXXXXXXXXXXXXXXXXX
XXXXXXXXXXXXXXXXXXXXXXXXXXXXXXXXXXXX---XXXXXXXXXXX-XXXXXXXXXXXXXXXXX---XXXXXXXXXXXXXXXXXXXXXXXXXXXXXXXXXXX---XXXXXXXXXXXXXXXXXXXXXXXXXXXXXXXXXXXXXXXXX
XXXXXXXXXXXXXXXXXXXXXXXXXXXXXXXXXXXX---XXXXXXXXXXX-XXXXXXXXXXXXXXXXX---XXXXXXXXXXXXXXXXXXXXXXXXXXXXXXXXXXX---XXXXXXXXXXXXXXXXXXXXXXXXXXXXXXXXXXXXXXXXX
