M-----------------------------------------------------------------------------------------------------------------------------------------------------
------------------------------------------------------------------------------------------------------------------------------------------------------
------------------------------------------------------------------------------------------------------------------------------------------------------
----k---------------------------------------k-----------------------------------------------------------------------------------o---------------------
--g---------------------------------------g---ooo----------------------------------k--------------k-------------k---------------o---------------------
-LL-------------LL-----------------------LLL--ooo--------------------------------g--L-----------g-------------g-----------------o----L----------------
----------------------------------------------ooo-------------oo----------------LL-------------LL---LL-----k--LL----------------------L---------------
-------------------oo-----------------------------------------oo----------ooo---------LL-----------------g------------------------ooo-----------------
---------------L---oo----------LL--g--------------------------oo-o--------ooo---------------------------LLL------L------o------g--oook--------LLL-----
-tt--L----------tt-oo-o------------L----XXXXX-tt-----------------o-----------------XXX------------------------------*---o-----XXX--g--tt-----------*--
-tt-------------tt----o-----------------XXXXX-tt-------k---------o--------------tt-XXX---------tt-XXXXX-----XXXXX-g-*-----k-*-XXX-tt--tt-----k-----*--
-tt-------------tt-----------XXXXX------XXXXX-tt-----g-----*--g--g--g-----------tt-XXXXXXX-----tt-XXXXX-----XXXXXXX-*---g---*-XXX-tt--tt---g--XXXX-*--
XXXXXXXXXXXX---XXXXXXXXXXX---XXXXXXXXXX-XXXXXXXXX--XXXXXXXXXXXXXXXXXX-XXX-XXXXXXXXXXXXXXXXXXXXXXXXXXXXXXXXXXXXXXXXXXXXXXXXXXXXXXXXXXXXXXXXXXXXXXXXXXXX
XXXXXXXXXXXX---XXXXXXXXXXX---XXXXXXXXXX-XXXXXXXXX--XXXXXXXXXXXXXXXXXX-XXX-XXXXXXXXXXXXXXXXXXXXXXXXXXXXXXXXXXXXXXXXXXXXXXXXXXXXXXXXXXXXXXXXXXXXXXXXXXXX
XXXXXXXXXXXX---XXXXXXXXXXX---XXXXXXXXXX-XXXXXXXXX--XXXXXXXXXXXXXXXXXX-XXX-XXXXXXXXXXXXXXXXXXXXXXXXXXXXXXXXXXXXXXXXXXXXXXXXXXXXXXXXXXXXXXXXXXXXXXXXXXXX
XXXXXXXXXXXX---XXXXXXXXXXX---XXXXXXXXXX-XXXXXXXXX--XXXXXXXXXXXXXXXXXX-XXX-XXXXXXXXXXXXXXXXXXXXXXXXXXXXXXXXXXXXXXXXXXXXXXXXXXXXXXXXXXXXXXXXXXXXXXXXXXXX
