M-----------------------------------------------------------------------------------------------------------------------------------------------------
------------------------------------------------------------------------------------------------------------------------------------------------------
------------------------------------------------------------------------------------------------------------------------------------------------------
------------------------------------------------------------------------------------------------------------------------------------------------------
----oo-------------------------------------------------------------------ooo----k----------------------------ooo--------------------------------------
----oo-------------------------------------------------------------------ooo--g------------------------------ooo--------------------------------------
----oo---------------------L---------------------------------------------ooo-LL------------------o-----------ooo-----ooo----------------LL------------
--------------------o------------L---------oooo--------------------------------------------------o-----k--------k----ooo------g-----k-----------------
-o------------------o----------------------oooo-----------------------------L--------LL--------------g--------g--------k------L---g--------oo--------L
-o-------tt-----tt------ooo---------tt--------------XXX----LLL---------------------------tt---XXXXXXXXXX-----tt------g----LL-----tt--------oo-L-----k-
-----tt--tt-----tt--tt--oooXX---XXX-tt-----------tt-XXX--------XXXX----k-tt--tt----------tt---XXXXXXXXXX-----tt----XXXXX---------tt-----tt-oo-----g---
-----tt--tt-----tt--tt-----XX---XXX-tt-----------tt-XXX--------XXXX--g---tt--tt----------tt---XXXXXXXXXX-g---tt----XXXXX---------tt--g--tt--g---XXXX--
XXXXXXXXXXXX---XXXXXXXXXXXXXX---XXXXXXX-XXXXXXXXXXXXXXXXXXXXXXXXXXXXXXXXXXXXXXXX---XXXXXXXXX--XXXXXXXXXXXXX-XXXX---XXXXX-XXXXXXXXXXXXXXXXXXXXXXXXXXXXX
XXXXXXXXXXXX---XXXXXXXXXXXXXX---XXXXXXX-XXXXXXXXXXXXXXXXXXXXXXXXXXXXXXXXXXXXXXXX---XXXXXXXXX--XXXXXXXXXXXXX-XXXX---XXXXX-XXXXXXXXXXXXXXXXXXXXXXXXXXXXX
XXXXXXXXXXXX---XXXXXXXXXXXXXX---XXXXXXX-XXXXXXXXXXXXXXXXXXXXXXXXXXXXXXXXXXXXXXXX---XXXXXXXXX--XXXXXXXXXXXXX-XXXX---XXXXX-XXXXXXXXXXXXXXXXXXXXXXXXXXXXX
XXXXXXXXXXXX---XXXXXXXXXXXXXX---XXXXXXX-XXXXXXXXXXXXXXXXXXXXXXXXXXXXXXXXXXXXXXXX---XXXXXXXXX--XXXXXXXXXXXXX-XXXX---XXXXX-XXXXXXXXXXXXXXXXXXXXXXXXXXXXX
