M-----------------------------------------------------------------------------------------------------------------------------------------------------
------------------------------------------------------------------------------------------------------------------------------------------------------
------------------------------------------------------------------------------------------------------------------------------------------------------
------------------------------------------------------------------------------------------------------------------------------------------------------
--------------k-------------------------------------------------------------------------------------------L-------------------------------k-----------
------------g-------------------------------oooo-----------------------------LLL--------------------------------------------------------g-------------
---LL--LL---L-------------oo--------LL------oooo----------------oo-------------------------o------------------------------------LL--g--LL--------k----
--------------------------------------------oooo-----------Lg---ooooo------o---------L-----o------LLL-----k------------------------LL----------g------
------------------------------------------------------------L---ook--------o------------------k--g------g------o-------------------------------LL-----
-------tt-----XXXX---LLL--g----LL------o------------LL----------g----------o-XXXXX-----XXX--g---XX-----tt--L-------------ooo---Ltt------------------g-
--XXXX-tt--tt-XXXX-------XXX------XXXXXo---XXXXX-------oo--k--XXXX-----------XXXXX---XXXXX-tt---XX-----tt--------k----tt-ooo-k--tt-XXX-tt---o-----XXXX
XXXXXX-tt--tt-XXXX-------XXXXX----XXXXX----XXXXX-g-------g-XXXXXXXXXXXXXXXX--XXXXX---XXXXX-tt---XXXXXX-tt------g------tt---g--g-tt-XXX-tt----XXXXXXXXX
XXXXXXXXXXXXXXXXXXXXXXXXXXXXXXXXXXXXXXXXX--XXXXXXXXXXXXXXXXXXXXXXXXXXXXXXXXXXXXXXX---XXXXXXXXXXXXXXXXXXXXXXXXXXXXXXXXXXXXXXXXXXXXXXXXXXXXXXXXXXXXXXXXX
XXXXXXXXXXXXXXXXXXXXXXXXXXXXXXXXXXXXXXXXX--XXXXXXXXXXXXXXXXXXXXXXXXXXXXXXXXXXXXXXX---XXXXXXXXXXXXXXXXXXXXXXXXXXXXXXXXXXXXXXXXXXXXXXXXXXXXXXXXXXXXXXXXX
XXXXXXXXXXXXXXXXXXXXXXXXXXXXXXXXXXXXXXXXX--XXXXXXXXXXXXXXXXXXXXXXXXXXXXXXXXXXXXXXX---XXXXXXXXXXXXXXXXXXXXXXXXXXXXXXXXXXXXXXXXXXXXXXXXXXXXXXXXXXXXXXXXX
XXXXXXXXXXXXXXXXXXXXXXXXXXXXXXXXXXXXXXXXX--XXXXXXXXXXXXXXXXXXXXXXXXXXXXXXXXXXXXXXX---XXXXXXXXXXXXXXXXXXXXXXXXXXXXXXXXXXXXXXXXXXXXXXXXXXXXXXXXXXXXXXXXX
