M-----------------------------------------------------------------------------------------------------------------------------------------------------
-----------------------------------------L------------------------------------------------------------------------------------------------------------
------------------------------------------------------------------------------------------------------------------------------------------------------
---------------------------------------------------------------------------------------------------------------------------------------------o--------
-----------------------------------------k---------------------------------------------------------------------------------------------------o--------
---------------------------------------g-------------------oo-----------LL-------------------------------------------------------------------o--------
-------------ooo----------oo---------LLL--LL---------------oo--LL----------------LL---o---------g-----------------------------------------------------
-------------ooo----------oo------------------------------------------------L---------o--L--LL--L------------------------------o----------------------
-o---L----------k----o----oo----L-----------------------------k-----------------------------------------LLL-----k--------------o--------------------LL
-o------------g--tt--o--g-----L----L-XXXX-tt----------------g-----LL----tt-L-----XXX--------------------------g-------------------tt----L--tt----tt---
-o-----------tt--tt--g-tt------------XXXX-tt-XXX---o---ko-XXXX-tt-------tt--tt---XXX--XX----tt-XXX-----------tt--*--TT--tt--tt----tt-------tt----tt---
-------------tt--tt-XX-tt--------g---XXXX-tt-XXX-----g----XXXX-tt-------tt--tt---XXX--XXXXX-tt-XXX-----------tt--*--TT--tt--tt--g-tt-----g-tt----tt-XX
XX---XX-XXXXXXXXXXXXXXXXXXXXXXXXXX-XXXXXXXXXXXXX---XXXXXXXXXXXXXXXXXX--XXXXXXXX--XXXXXXXXXXXXXXXXX----XXXXXXXXXXXXXXXXXXXXXXXXXXXXXXX---XXXXXXXXXXXXXX
XX---XX-XXXXXXXXXXXXXXXXXXXXXXXXXX-XXXXXXXXXXXXX---XXXXXXXXXXXXXXXXXX--XXXXXXXX--XXXXXXXXXXXXXXXXX----XXXXXXXXXXXXXXXXXXXXXXXXXXXXXXX---XXXXXXXXXXXXXX
XX---XX-XXXXXXXXXXXXXXXXXXXXXXXXXX-XXXXXXXXXXXXX---XXXXXXXXXXXXXXXXXX--XXXXXXXX--XXXXXXXXXXXXXXXXX----XXXXXXXXXXXXXXXXXXXXXXXXXXXXXXX---XXXXXXXXXXXXXX
XX---XX-XXXXXXXXXXXXXXXXXXXXXXXXXX-XXXXXXXXXXXXX---XXXXXXXXXXXXXXXXXX--XXXXXXXX--XXXXXXXXXXXXXXXXX----XXXXXXXXXXXXXXXXXXXXXXXXXXXXXXX---XXXXXXXXXXXXXX
