M-----------------------------------------------------------------------------------------------------------------------------------------------------
------------------------------------------------------------------------------------------------------------------------------------------------------
------------------------------------------------------------------------------------------------------------------------------------------------------
---------------------------------------------------------------------------------------------------------------------------------------L--------------
-----------------k------------------------------------------------------------------------------------------------------------------------------------
---------------g--------------------oo-----------------------ooo--------------------------------------------------------------------L-----------------
-----------L--LL--oo----------------oo---LL--L--------------------------------------L--------oo--------------oo-------------------------LL--------ooo-
-------------------------------------------------------------------------------k-------------oo--------------oo-------------g----------k----------ooo-
-------------L--------------------------------------------L-------------o----g-----L------------k----LL------oo-------g----LL------L-g------------ooo-
----g--LLL--g-----tt--*--LL----------tt---------------L------TT---------o---tt----------------g----------------------XXX---------*--tt---------k------
---XXX-----XX-tt--tt--*---------k----tt--tt-XXX-----g--------TT--*--------k-tt--tt--tt-------tt-----------tt--g-XXXXXXXX---------*--tt--tt---g--------
---XXX-----XX-tt--tt--*-------g------tt--tt-XXXXXXXXX--------TT--*------g---tt--tt--tt-XXXXX-tt------XXXX-tt-XXXXXXXXXXX---------*--tt--tt-XXXXXXXXXX-
---XXXXXXXXXXXXXXXXXXXXXXXXXXXXXXXXXXXXXXXXXXXXXXXXXXXXXXXXXXXXXXXXXXXXXXXXXXXXXXXXXXXXXXXXXXXXXXXXXXXXXXXXXXXXXXXXXXXXXXXXXXX--XXXXXXXXXXXXXXXXXXXXXX
---XXXXXXXXXXXXXXXXXXXXXXXXXXXXXXXXXXXXXXXXXXXXXXXXXXXXXXXXXXXXXXXXXXXXXXXXXXXXXXXXXXXXXXXXXXXXXXXXXXXXXXXXXXXXXXXXXXXXXXXXXXX--XXXXXXXXXXXXXXXXXXXXXX
---XXXXXXXXXXXXXXXXXXXXXXXXXXXXXXXXXXXXXXXXXXXXXXXXXXXXXXXXXXXXXXXXXXXXXXXXXXXXXXXXXXXXXXXXXXXXXXXXXXXXXXXXXXXXXXXXXXXXXXXXXXX--XXXXXXXXXXXXXXXXXXXXXX
---XXXXXXXXXXXXXXXXXXXXXXXXXXXXXXXXXXXXXXXXXXXXXXXXXXXXXXXXXXXXXXXXXXXXXXXXXXXXXXXXXXXXXXXXXXXXXXXXXXXXXXXXXXXXXXXXXXXXXXXXXXX--XXXXXXXXXXXXXXXXXXXXXX
