M-----------------------------------------------------------------------------------------------------------------------------------------------------
------------------------------------------------------------------------------------------------------------------------------------------------------
------------------------------------------------------------------------------------------------------------------------------------------------------
------------------------------------------------------------------------------------------------------------------------------------------------------
------------------------------------------------------------------------------------------------------------------------------------------------------
--------------------LL--------------------------------------------------------------------------------------------------------------------------------
---------------------------------o----------------------o-----------LL-------------------------------------L--oo--L--------------------k--------------
-ooLL----------------------------oL---------------------o--oooo---------LL-----k---------------o--------------oo----------------LL---g---------k------
-oo------------------------------o------o-----------------koooo--------------g-------L---------o--------------oo-k-----------LL-----LLL--L---g--------
-oo----tt--L--L--*-XXXX--------------tt--g-tt-----L-----g-----k-----tt------tt---------------g-o-LLL------tt---g-XXX-LL---------------------tt--------
-------tt--------*-XXXX-oo-k-tt--g---tt-XX-tt----------tt---g---tt--tt-XXXX-tt----------tt--TT--g------*--tt--tt-XXX------------------------tt-----k--
-g-XXX-tt--------*-XXXX--g---tt-XXXX-tt-XX-tt----------tt-XXXXX-tt--tt-XXXX-tt----------tt--TT-XX------*--tt--tt-XXX------------XXXXXXXX----tt---g----
XXXXXXXXXXXXXXXXXXXXXXXXXXXXXXXXXXXXXXXXXXXXXX---XXX--XXXXXXXXXXXXXXXXXXXXXXXXX---XXXXXXXXXXXXXXXXXXXXXXXXXXXXXXXXXXXXXXXXXXXXXXXXXXXXXXXXXXXXXXXXXXXX
XXXXXXXXXXXXXXXXXXXXXXXXXXXXXXXXXXXXXXXXXXXXXX---XXX--XXXXXXXXXXXXXXXXXXXXXXXXX---XXXXXXXXXXXXXXXXXXXXXXXXXXXXXXXXXXXXXXXXXXXXXXXXXXXXXXXXXXXXXXXXXXXX
XXXXXXXXXXXXXXXXXXXXXXXXXXXXXXXXXXXXXXXXXXXXXX---XXX--XXXXXXXXXXXXXXXXXXXXXXXXX---XXXXXXXXXXXXXXXXXXXXXXXXXXXXXXXXXXXXXXXXXXXXXXXXXXXXXXXXXXXXXXXXXXXX
XXXXXXXXXXXXXXXXXXXXXXXXXXXXXXXXXXXXXXXXXXXXXX---XXX--XXXXXXXXXXXXXXXXXXXXXXXXX---XXXXXXXXXXXXXXXXXXXXXXXXXXXXXXXXXXXXXXXXXXXXXXXXXXXXXXXXXXXXXXXXXXXX
