M-----------------------------------------------------------------------------------------------------------------------------------------------------
------------------------------------------------------------------------------------------------------------------------------------------------------
------------------------------------------------------------------------------------------------------------------------------------------------------
---------------------------------------------------------------------------------------------------------------------------ooL------------------------
----------------------------------------------------g--------------------------------------koo-----------------------------oo-------------------------
-L---------ooo------------------------oo------------L-L----------------------------------g--oo----------ooo----------------oo------------LL--------L--
------------------------L------L------oo------------------------------------------------LL--oo----------ooo-----L-----L-------------------------------
----------o---------------------------------------k----------------------------------------------LL-----k---k----------------k------------------------
----g-----o------------L-----------------k------g------------------------------------L-L--------------g---g---------oL-----g--------------------------
XXXXXX------tt----oo-*------tt-XXXXX---g--------LL-XXXXX---tt-------oooo-XXXX---------------tt-------tt-XXXX-------------XXXX------------TT-------tt--
XXXXXX------tt----oo-*--tt--tt-XXXXX--tt-----------XXXXX---tt--XXXXXooookXXXX-----------tt--tt-------tt-XXXX-tt-XX-XX-tt-XXXX------------TT-------tt--
XXXXXX------tt----g--*--tt--tt-XXXXX--tt-----------XXXXX-g-tt--XXXXX--g--XXXX-g-XXXXX-g-tt--tt-XXXXX-tt-XXXX-tt-XX-XX-tt-XXXX------*--g--TT-------tt--
XXXXXXXXXXXXXXX--XXXXXXXXXXXXXXXXXXX-XXXXXXXXXXXXXXXXXXXXXXXXX-XXXXXXXXXXXXXXXXXXXXXXXXXXXXXXXXXXXXXXXXXXXXXXXXXXX-XXXXXXXXXXXX---XXXXXXXXXX-XXX-XXXXX
XXXXXXXXXXXXXXX--XXXXXXXXXXXXXXXXXXX-XXXXXXXXXXXXXXXXXXXXXXXXX-XXXXXXXXXXXXXXXXXXXXXXXXXXXXXXXXXXXXXXXXXXXXXXXXXXX-XXXXXXXXXXXX---XXXXXXXXXX-XXX-XXXXX
XXXXXXXXXXXXXXX--XXXXXXXXXXXXXXXXXXX-XXXXXXXXXXXXXXXXXXXXXXXXX-XXXXXXXXXXXXXXXXXXXXXXXXXXXXXXXXXXXXXXXXXXXXXXXXXXX-XXXXXXXXXXXX---XXXXXXXXXX-XXX-XXXXX
XXXXXXXXXXXXXXX--XXXXXXXXXXXXXXXXXXX-XXXXXXXXXXXXXXXXXXXXXXXXX-XXXXXXXXXXXXXXXXXXXXXXXXXXXXXXXXXXXXXXXXXXXXXXXXXXX-XXXXXXXXXXXX---XXXXXXXXXX-XXX-XXXXX
