M-----------------------------------------------------------------------------------------------------------------------------------------------------
------------------------------------------------------------------------------------------------------------------------------------------------------
------------------------------------------------------------------------------------------------------------------------------------------------------
------------------------------------------------------------------------------------------------------------------------------------------------------
--------------------ooo---------------------------------------------------------------------------------o---------------------------------------------
--------------------ooo-----------------------------------------o---------------------------------------o-------------------o----oo--oo---------------
--------------------ooo---------------ooo-----------------------o-------------L----------------------k--o------------------------oo-------------------
---------g--------------k-------oooo--ooo---------------------------oo-------------------o---------g--------------oo----------o-----k-----------------
--------LL--o---------g---------------ooo---------------------------ooo---------------------------LL-----k--------------------o---g-------------------
------------o-*---*--tt--LL----XXXXX------tt---------XXX--------tt--oo--------XXXX-------XXXX----------g-----oo------------XX-o--tt---tt--------------
---XXXXX------*---*--tt------*-XXXXX------tt---tt----XXX------k-tt------------XXXX------oXXXX----k---XXXX----oo---tt---*---XX----tt---tt-------------g
---XXXXX---XX-*---*--tt------*-XXXXX------tt---tt----XXX----g---tt--g--g------XXXX-------XXXX--g-XXXXXXXXXXXX-----tt---*---XXXXX-tt---tt-XXXX------XXX
XXXXXXXXXXXXXXXX-XXXXXXXXXXXXXXXXXXXXXXXXXXXX-XXXX---XXX--XXXXXXXXXXXXXXXXXXX-XXXXXXXXXXXXXXXXXXXXXXXXXXXXXXXXXXXXXXX-XXX--XXXXXXXXX-XXXXXXXXXXXX-XXXX
XXXXXXXXXXXXXXXX-XXXXXXXXXXXXXXXXXXXXXXXXXXXX-XXXX---XXX--XXXXXXXXXXXXXXXXXXX-XXXXXXXXXXXXXXXXXXXXXXXXXXXXXXXXXXXXXXX-XXX--XXXXXXXXX-XXXXXXXXXXXX-XXXX
XXXXXXXXXXXXXXXX-XXXXXXXXXXXXXXXXXXXXXXXXXXXX-XXXX---XXX--XXXXXXXXXXXXXXXXXXX-XXXXXXXXXXXXXXXXXXXXXXXXXXXXXXXXXXXXXXX-XXX--XXXXXXXXX-XXXXXXXXXXXX-XXXX
XXXXXXXXXXXXXXXX-XXXXXXXXXXXXXXXXXXXXXXXXXXXX-XXXX---XXX--XXXXXXXXXXXXXXXXXXX-XXXXXXXXXXXXXXXXXXXXXXXXXXXXXXXXXXXXXXX-XXX--XXXXXXXXX-XXXXXXXXXXXX-XXXX
