M-----------------------------------------------------------------------------------------------------------------------------------------------------
------------------------------------------------------------------------------------------------------------------------------------------------------
------------------------------------------------------------------------------------------------------------------------------------------------------
------------------------------------------------------------------------------------------------------------------------------------------------------
------------------------------------------------------------------------------------------------------------------------------------------------------
-g---------------------U--------------------------------------------g---------------------------------------------------------------------------------
-U---------------------------------------------------------ooo-----oo----------------------------------------------------------------------g----------
---------------------------oo------------o-----oo--o-------ooo-----oo------------------o----------------------------o--o-------------------LL---------
-----------o---------oU----oo------------o-----oo--o-------ooo-o---oo-ooo--------------o------------------------oo-----o----------g-------------------
XXX--------o---------o-tt--oo----XXXXX---o-----oo-o-g----------o---tt-ooo------o--------------------------------ko-g---o---*--*--tt--*---------g------
XXX--g-----o--o-tt-----tt--------XXXXX------------ott-o-XX---------tt---------ko------XXXXXXX---k--tt----k-----g--XXX------*--*--tt--*-------XXXX-----
XXX-ooo-------o-tt--g--tt-XXX--g-XXXXX-----*-XXXXX-tt-o-XXXXXX-----tt--------g--------XXXXXXX--g---tt---g----XXXXXXXX-g----*--*--tt--*----XXXXXXXXXXX-
XXXXXXX---XXXXXXXXXXXXXXXXXXXXXXXXXXXXXXXXXXXXXXXXXXXXXXXXXXXXXXXXXXXXXXXXXXXXXX---XXXXXXXXXXXXXXXXXXXXXXXXXXXXXXXXXXXXX--XXXXXXXXXXXXX---XXXXXXXXXXXX
XXXXXXX---XXXXXXXXXXXXXXXXXXXXXXXXXXXXXXXXXXXXXXXXXXXXXXXXXXXXXXXXXXXXXXXXXXXXXX---XXXXXXXXXXXXXXXXXXXXXXXXXXXXXXXXXXXXX--XXXXXXXXXXXXX---XXXXXXXXXXXX
XXXXXXX---XXXXXXXXXXXXXXXXXXXXXXXXXXXXXXXXXXXXXXXXXXXXXXXXXXXXXXXXXXXXXXXXXXXXXX---XXXXXXXXXXXXXXXXXXXXXXXXXXXXXXXXXXXXX--XXXXXXXXXXXXX---XXXXXXXXXXXX
XXXXXXX---XXXXXXXXXXXXXXXXXXXXXXXXXXXXXXXXXXXXXXXXXXXXXXXXXXXXXXXXXXXXXXXXXXXXXX---XXXXXXXXXXXXXXXXXXXXXXXXXXXXXXXXXXXXX--XXXXXXXXXXXXX---XXXXXXXXXXXX
