M-----------------------------------------------------------------------------------------------------------------------------------------------------
------------------------------------------------------------------------------------------------------------------------------------------------------
------------------------------------------------------------------------------------------------------------------------------------------------------
----------------------------------------------------------------------------------------k-------------------------------------------------------------
---------------------------o----------------------------------------------------------g---------------------------------------------------------------
---------------------------o-------------------------------------------k-------------LL---------------------------------------------------------------
------------------LL-------o----ooo---o-------L-LL------L------------g--------------------------------------------o-----------------------ooo---------
------------------------o-------ooo---o-----------------------------LLL---------oooo----------------LL------------o-----------------------oook-oo-----
--------------LL-L---L----------------o----------------k-------o-L--------------ooooL-------L---------------------o-o----------------------g-o-oo-----
-----------------------------LL--------------tt------g-----g---o----------oo-L--oooo-tt-----------k-----------------o--------------------XXXX-goo-----
------------------tt---XX--XX---XXXX---------tt-XXX-tt-XXXXXX------XXXXX--ook--------tt--o------g---tt-------XXXX-g-------------k--------XXXXXX-------
--------*---------tt---XX--XX---XXXX------g--tt-XXX-tt-XXXXXX-----gXXXXX--g----XXXXX-tt---g--gXXXXX-tt--g--g-XXXXXXX-g--------g--------*-XXXXXX----g--
XXXXXXXXXX----XXXXXXXXXXXXXXXXXXXXXXXXXXXXXXXXXXXXXXXXXXXXXXXXXXXXXXXXXXXXXXXXXXXXXXXXXX-XXXXXXXXXXXXXXXXXXXXXXXXXXXXXXXXXXXXXXXXXXXXXXXXXXXXXXXXXXXXX
XXXXXXXXXX----XXXXXXXXXXXXXXXXXXXXXXXXXXXXXXXXXXXXXXXXXXXXXXXXXXXXXXXXXXXXXXXXXXXXXXXXXX-XXXXXXXXXXXXXXXXXXXXXXXXXXXXXXXXXXXXXXXXXXXXXXXXXXXXXXXXXXXXX
XXXXXXXXXX----XXXXXXXXXXXXXXXXXXXXXXXXXXXXXXXXXXXXXXXXXXXXXXXXXXXXXXXXXXXXXXXXXXXXXXXXXX-XXXXXXXXXXXXXXXXXXXXXXXXXXXXXXXXXXXXXXXXXXXXXXXXXXXXXXXXXXXXX
XXXXXXXXXX----XXXXXXXXXXXXXXXXXXXXXXXXXXXXXXXXXXXXXXXXXXXXXXXXXXXXXXXXXXXXXXXXXXXXXXXXXX-XXXXXXXXXXXXXXXXXXXXXXXXXXXXXXXXXXXXXXXXXXXXXXXXXXXXXXXXXXXXX
