M-----------------------------------------------------------------------------------------------------------------------------------------------------
------------------------------------------------------------------------------------------------------------------------------------------------------
------------------------------------------------------------------------------------------------------------------------------------------------------
----------------------------------------------------------------------------ooo-----------------------------------------------------------------------
----------------------------------------------------------------------------ooo---------------------------------------------------------------ooo-----
o-------------------------------------------------------------ooo-----o-----ooo----------o----------------------------------------------------ooo-----
---------------------------------------ooo-------------L------ooo-----o------------------o--LL------------------------------------------------ooo-----
------oo-------------------------------ooo--------------------ooo----------------LL---LL-o------------ooo----------k-----------------L----------------
------oo-----o-------------------------ooo-----k------L-----------k---kooo--------------------------o------------g-oo-----------------------------LL--
XXX-----XXXX-o---------XXXXX------*----------g----XXXX----------g---g--ooo--tt------------g----XXX--------------tt------L------LLL-------o-----tt-----
XXX-----XXXX-o--k------XXXXX------*----XXXX-tt----XXXX-tt-----ktt-XXXXXooo--tt-XXXXX-----XXXXXXXXX-----tt-------tt------------k-----tt-----k---tt-----
XXX-----XXXX--g------*-XXXXXXXXXX-*----XXXX-tt----XXXX-tt---g--tt-XXXXX-----tt-XXXXXXXXXXXXXXXXXXXXX-g-tt-XXXXX-tt--g-------g-------tt---g-----tt-XXXX
XXXXXXXXXXXXXXXXX---XXXXXXXXXXXXXXXXXXXXXXXXXXX---XXXXXXXXXXXXXXXXXXXXXXXXXXXXXXXXXXXXXXXXXXXXXXXXXXXXXXXXXXXXXXXXXXXXXXXXXXXXXXXXXXXXXXXXXX--XXXXXXXX
XXXXXXXXXXXXXXXXX---XXXXXXXXXXXXXXXXXXXXXXXXXXX---XXXXXXXXXXXXXXXXXXXXXXXXXXXXXXXXXXXXXXXXXXXXXXXXXXXXXXXXXXXXXXXXXXXXXXXXXXXXXXXXXXXXXXXXXX--XXXXXXXX
XXXXXXXXXXXXXXXXX---XXXXXXXXXXXXXXXXXXXXXXXXXXX---XXXXXXXXXXXXXXXXXXXXXXXXXXXXXXXXXXXXXXXXXXXXXXXXXXXXXXXXXXXXXXXXXXXXXXXXXXXXXXXXXXXXXXXXXX--XXXXXXXX
XXXXXXXXXXXXXXXXX---XXXXXXXXXXXXXXXXXXXXXXXXXXX---XXXXXXXXXXXXXXXXXXXXXXXXXXXXXXXXXXXXXXXXXXXXXXXXXXXXXXXXXXXXXXXXXXXXXXXXXXXXXXXXXXXXXXXXXX--XXXXXXXX
