M-----------------------------------------------------------------------------------------------------------------------------------------------------
------------------------------------------------------------------------------------------------------------------------------------------------------
------------------------------------------------------------------------------------------------------------------------------------------------------
------------------------------------------------------------------------------------------------------------------------------------------------------
------------------------------------------------------------------------------------------------------------------------------------------------------
---------------------------------o--------------------------------------------------------------------------------------------o-----------------L-----
-----------------------LL--------o---------LLL---------------------------------------------------------------o----------------o-----------------------
-ooo---------------------------------------------LLL-------------------------o---oo--------k-----------------o----------------o-----------------------
------------o---------k---L-----g--------------------------------------------o---oo------g-------------------o-----o---------------------------L------
------------o-------g--tt----*-XX-g-LL---------------LL------tt-L-LLL--------o--k----L--tt----------XXX-*----------o-L-oo--------------L--------tt--tt
-tt----tt---o------tt--tt----*-XXXX-----tt-XXXXXXXXXX--------tt---------------g---------tt-----XXXXXXXX-*----------o----------XXX------------g--tt--tt
-tt--g-tt----------tt--tt--g-*-XXXX-----tt-XXXXXXXXXX--------tt-------------XXXXX-------tt-----XXXXXXXX-*---------------------XXX-----------XXX-tt--tt
XXXXXXXXXXXXXXX---XXXXXXXXXXXXXXXXXXXXXXXXXXXXXXXXXXXXXXXXXXXXXXXXXXXXXXXXXXXXXXXXXXXXXXXXXXXXXXXXXXXXXXXX---XXXXXXXXXXXXXXX--XXXXX----XX---XXXXXXXXXX
XXXXXXXXXXXXXXX---XXXXXXXXXXXXXXXXXXXXXXXXXXXXXXXXXXXXXXXXXXXXXXXXXXXXXXXXXXXXXXXXXXXXXXXXXXXXXXXXXXXXXXXX---XXXXXXXXXXXXXXX--XXXXX----XX---XXXXXXXXXX
XXXXXXXXXXXXXXX---XXXXXXXXXXXXXXXXXXXXXXXXXXXXXXXXXXXXXXXXXXXXXXXXXXXXXXXXXXXXXXXXXXXXXXXXXXXXXXXXXXXXXXXX---XXXXXXXXXXXXXXX--XXXXX----XX---XXXXXXXXXX
XXXXXXXXXXXXXXX---XXXXXXXXXXXXXXXXXXXXXXXXXXXXXXXXXXXXXXXXXXXXXXXXXXXXXXXXXXXXXXXXXXXXXXXXXXXXXXXXXXXXXXXX---XXXXXXXXXXXXXXX--XXXXX----XX---XXXXXXXXXX
