M-----------------------------------------------------------------------------------------------------------------------------------------------------
------------------------------------------------------------------------------------------------------------------------------------------------------
------------------------------------------------------------------------------------------------------------------------------------------------------
----------------------oo--------------------------------------------------------------------------------------------------k---------------------------
----------------------oo--------------------------------------k------------L--------------------------------------k-----g-----------------------------
----------------------oo--------kLL----------ooo------------g-------------------------oo---------------LLL------g------LL-------oo--------------------
-----g------------------------g--------------ooo-----------LL-------LL-----------------------------------------LL--LL-----------oo-LL------oo---------
----kL-------------------k---LL----------------------------------------------------------k-oo----------------------------------------------oo---------
--g----------LL--------g---------------------------------------------------kLL---L-----g---oo-----------------------------------g---------------------
-tt-------------------tt---------tt----------tt---------------------tt---g-----------XXXXX-oo--------L-XXXX---XXXX----XXXX-----XXXLtt-o--XXXX---------
-tt-------------XXXXX-tt-XXXXXXX-tt----------tt----XXX-TT--tt-------tt--tt-----------XXXXX----k-tt-----XXXX---XXXXXXXXXXXX-----XXX-tt----XXXX---------
-tt-XXX---------XXXXX-tt-XXXXXXX-tt-------*--tt----XXX-TT--tt-------tt--tt-----------XXXXX--g---tt----gXXXX---XXXXXXXXXXXX-----XXX-tt-XX-XXXX---------
XXXXXXX-XXX-XXXXXXXXXXXXXXXXXXXXXXXXXXXXXXXXXXXX---XXXXXXXXXXXXXXXXXXXXXXXXXXXXXXXX--XXXXXXXXXXXXXX--XXXXXX---XXXXXXXXXXXXXXXXXXXXXXXXXX-XXXX---XXXXXX
XXXXXXX-XXX-XXXXXXXXXXXXXXXXXXXXXXXXXXXXXXXXXXXX---XXXXXXXXXXXXXXXXXXXXXXXXXXXXXXXX--XXXXXXXXXXXXXX--XXXXXX---XXXXXXXXXXXXXXXXXXXXXXXXXX-XXXX---XXXXXX
XXXXXXX-XXX-XXXXXXXXXXXXXXXXXXXXXXXXXXXXXXXXXXXX---XXXXXXXXXXXXXXXXXXXXXXXXXXXXXXXX--XXXXXXXXXXXXXX--XXXXXX---XXXXXXXXXXXXXXXXXXXXXXXXXX-XXXX---XXXXXX
XXXXXXX-XXX-XXXXXXXXXXXXXXXXXXXXXXXXXXXXXXXXXXXX---XXXXXXXXXXXXXXXXXXXXXXXXXXXXXXXX--XXXXXXXXXXXXXX--XXXXXX---XXXXXXXXXXXXXXXXXXXXXXXXXX-XXXX---XXXXXX
