M-----------------------------------------------------------------------------------------------------------------------------------------------------
------------------------------------------------------------------------------------------------------------------------------------------------------
------------------------------------------------------------------------------------------------------------------------------------------------------
----L-------------------------------------------------------------------------------------------------------------------------------------------------
-------------------------------------------------------------------------------------------L-oo--------------------oooo-------------------------------
---------------------------------------------L------------------------------------------L----oo-------------LL-----oooo-------------------------------
oo-----LL-------------------ooo----------ooo--LL-------------o-----------------------------------------------------oooo-------------------------------
----k-----------------------ooo----------ooo----------oo-----------------------------------k--------------------g-------------------------------------
--g---L--------------oo------------------ooo-k------------------k--------------LL------L-g---------oo----------LL---------------------------------ooo-
-tt--------LL----LL--oo---------k-----*----g--tt--LL--tt------g--tt--tt-L-----------LL--tt----tt---oo-*-----TT----XXXXX------------tt-L--tt-----g-ooo-
-tt----TT------------oo-------g---tt--*---TT--tt------tt-----tt--tt--tt-----------------tt-XX-tt------*-----TT----XXXXX----k-------tt----tt----tt-ooo-
-tt----TT------------g------XXXXX-tt--*---TT--tt------tt-----tt--tt--tt-----------------tt-XX-tt------*-----TT----XXXXX--g--XXXXX--tt----tt----tt-----
XXXXXXXXXXXXXXXXXXXXXXX---XXXXXXXXXXXXXX-XXXXXXXXXXXXXXXX---XXXXXXXXXXXXXX-XXX-XXXXXXXXXXXXXXXXXXXXXXXXX---XXXXXXXXXXXXXXXXXXXXXX-XXXXXXXXXX--XXXXXXXX
XXXXXXXXXXXXXXXXXXXXXXX---XXXXXXXXXXXXXX-XXXXXXXXXXXXXXXX---XXXXXXXXXXXXXX-XXX-XXXXXXXXXXXXXXXXXXXXXXXXX---XXXXXXXXXXXXXXXXXXXXXX-XXXXXXXXXX--XXXXXXXX
XXXXXXXXXXXXXXXXXXXXXXX---XXXXXXXXXXXXXX-XXXXXXXXXXXXXXXX---XXXXXXXXXXXXXX-XXX-XXXXXXXXXXXXXXXXXXXXXXXXX---XXXXXXXXXXXXXXXXXXXXXX-XXXXXXXXXX--XXXXXXXX
XXXXXXXXXXXXXXXXXXXXXXX---XXXXXXXXXXXXXX-XXXXXXXXXXXXXXXX---XXXXXXXXXXXXXX-XXX-XXXXXXXXXXXXXXXXXXXXXXXXX---XXXXXXXXXXXXXXXXXXXXXX-XXXXXXXXXX--XXXXXXXX
