M-----------------------------------------------------------------------------------------------------------------------------------------------------
------------------------------------------------------------------------------------------------------------------------------------------------------
------------------------------------------------------------------------------------------------------------------------------------------------------
------------------------------------------------------------------------------------------------------------------------------k-----------------------
----------------------------------------------------------------------------------------------------------------------------g-------------------------
-------------------------------o----------------LL-----------------LL--LL----------------------------------------g---------LL------------------------L
-------------------------------o--------------------------------------------------------------------------------LL-----------------LL-----------------
-------------------------------o-------------------------------------------------------oooo------------------------o-----k---------------------LL-L---
------------o------------------------------LLL-----LLL------------L---L----------------oooo--------LL--------------o---g----------------LLL-L---------
-----------k---*-------XXXXX-------LL-----------tt--------oooo-----tt--tt-XXXX----XX---oooo---------------------XXXo-XXXXX-tt--o---XXXXX-------------t
-----*---g-----*--tt---XXXXX---XXX--------------tt------------k----tt--tt-XXXX----XX-------k-----*--------------XXX-gXXXXX-tt--o---XXXXX-------TT--g-t
-----*-XXXX-g--*--tt--gXXXXX---XXX--------g-----tt----------g---*--tt--tt-XXXX--g-XX-----g-------*----------*-XXXXXXXXXXXX-tt------XXXXXXXXX---TT-XX-t
XXXXXXXXXXXXXXXXXXXXXXXXXXXX---XXXXXXXXXXXXXXXXXXXXXXXXX--XXXXXXXXXXXXXXXXXXXXXXXXXXXXXXXXXX----XXXXXXXXXXXXXXXXXXXXXXXXXXXXXXXXXXXXXXXXXXXXXXXXXXXXXX
XXXXXXXXXXXXXXXXXXXXXXXXXXXX---XXXXXXXXXXXXXXXXXXXXXXXXX--XXXXXXXXXXXXXXXXXXXXXXXXXXXXXXXXXX----XXXXXXXXXXXXXXXXXXXXXXXXXXXXXXXXXXXXXXXXXXXXXXXXXXXXXX
XXXXXXXXXXXXXXXXXXXXXXXXXXXX---XXXXXXXXXXXXXXXXXXXXXXXXX--XXXXXXXXXXXXXXXXXXXXXXXXXXXXXXXXXX----XXXXXXXXXXXXXXXXXXXXXXXXXXXXXXXXXXXXXXXXXXXXXXXXXXXXXX
XXXXXXXXXXXXXXXXXXXXXXXXXXXX---XXXXXXXXXXXXXXXXXXXXXXXXX--XXXXXXXXXXXXXXXXXXXXXXXXXXXXXXXXXX----XXXXXXXXXXXXXXXXXXXXXXXXXXXXXXXXXXXXXXXXXXXXXXXXXXXXXX
