M-----------------------------------------------------------------------------------------------------------------------------------------------------
------------------------------------------------------------------------------------------------------------------------------------------------------
------------------------------------------------------------------------------------------------------------------------------------------------------
------------------------------------------------------------------------------------------------------------------------------------------------------
-------------------------------------------------------------------------------------------------------------------------k---------------------------g
------ooo-----------------------------------------------------------------k--------------------------------------------g----------------------------LL
------ooo-------------------LL--LL--------------------------------------g-----------------oo----------o----------------L---o---------------L----------
------ooo-----koo---o--------------------------------------------------LL-----------------------------o--------------------o--------------------------
-g--------k-g--oo--------------L-------------------------------------------------g-L------------------o----------------------------------g---------L--
XX-tt---g--tt--oo--XX----L-----------------L-------------------------------------L-------tt---------------TT----------tt--tt--L--o------XXLtt-------tt
XX-tt-XXXX-tt------XX-------tt--tt-----tt---------k*------------oook---tt----------------tt-------o-------TT----------tt--tt-----o---tt-XX-tt-------tt
XX-tt-XXXX-tt-XXXXXXX-------tt--tt--*--tt-------g--*-------*--g--g-----tt----------------tt---------------TT-----g----tt--tt---------tt-XX-tt----*--tt
XXXXXXXXXXXXXXXXXXXXX----XXXXXXXXXXXXXXXXXXXX-XXXXXXXXXXXXXXXXXXXXXXXXXXXXXXXXX-XXXXXXXXXXXX--XXXXXXXXXXXXXXX---XX---XXXXXXXXXXXXXXXXXXXXXXXXX--XXXXXX
XXXXXXXXXXXXXXXXXXXXX----XXXXXXXXXXXXXXXXXXXX-XXXXXXXXXXXXXXXXXXXXXXXXXXXXXXXXX-XXXXXXXXXXXX--XXXXXXXXXXXXXXX---XX---XXXXXXXXXXXXXXXXXXXXXXXXX--XXXXXX
XXXXXXXXXXXXXXXXXXXXX----XXXXXXXXXXXXXXXXXXXX-XXXXXXXXXXXXXXXXXXXXXXXXXXXXXXXXX-XXXXXXXXXXXX--XXXXXXXXXXXXXXX---XX---XXXXXXXXXXXXXXXXXXXXXXXXX--XXXXXX
XXXXXXXXXXXXXXXXXXXXX----XXXXXXXXXXXXXXXXXXXX-XXXXXXXXXXXXXXXXXXXXXXXXXXXXXXXXX-XXXXXXXXXXXX--XXXXXXXXXXXXXXX---XX---XXXXXXXXXXXXXXXXXXXXXXXXX--XXXXXX
