------------------------------------------------------------------------------------------------------------------------------------------------------
------------------------------------------------------------------------------------------------------------------------------------------------------
------------------------------------------------------------------------------------------------------------------------------------------------------
------------------------------------------------------------------------------------------------------------------------------------------------------
---------------------------------------------------------------------------------------------------ooo------------------------------------------------
-----------------------ooooo--------------------------------------------------ooo------------------ooo------------------------------------------------
-----------------------ooooo--------------------------------------------------ooo------------------ooo--------------------------------oooo----------C-
------------------------------------------------------------------------------------------------------------------------------------------------------
----------------------------------------LLLLL---------!!------ooo-------------------------------------------------------------------------------------
---------------------y------------------------------------------------ooo-------------------------------------------------------------------g---------
---------------------tt*----------------------------------------TT*-y-ooo--g--*------ooo--------r--tt--------------------U---------------tt----@@@@@--
-------------tt------tt*------g--------------LLLLL-----%------ttTT*tt-ooo%---**------ooo---ooo--%%%tt%%%*---*-------CCC-U------------TT--tttt---------
-----!-------tt------tt*-----*----r----C---------------%-tt---ttTT*tt%%%%%---**--oooo-----------%%%tt%%%*---*----------o-------------TT%%tttt---tt*-%%
M-------y----tt------tt*-----*--%%%%-g--------------y--%%tt---ttTT*tt%%%%%---**----------r------%%%tt%%%*%%%*----k----------y--------TT%%tttt%%%tt*%%%
XXXXXXXXXXXX-XXXXXXX-XXXXXXXXX--XXXXXXXXX---XXXXXXXXXXXXXXX---XXXXXXXXXXXX---XX------XXXXXXXXXXXXXXXXXXXXXXXXXXXXXXXXXXXXXXX----XXXXXXXXXXXXXXXXXXXXXX
XXXXXXXXXXXX-XXXXXXX-XXXXXXXXX--XXXXXXXXX---XXXXXXXXXXXXXXX---XXXXXXXXXXXX---XX------XXXXXXXXXXXXXXXXXXXXXXXXXXXXXXXXXXXXXXX----XXXXXXXXXXXXXXXXXXXXXX
