------------------------------------------------------------------------------------------------------------------------------------------------------
------------------------------------------------------------------------------------------------------------------------------------------------------
------------------------------------------------------------------------------------------------------------------------------------------------------
------------------------------------------------------------------------------------------------------------------------------------------------------
------------------------------------------------------------------------------------------------------------------------------------------------------
-------------------------------------------------------@@---------------------------------------------------------------------------------------------
--@@@@@-----------------------------------ooo-----------------------------------------------------------------------------------!!!!!-----------------
------------------------------------------ooo----------------------------------------------------------------UUUUU---@@@@-----------------------------
LL--------C-------------------------------ooo--------------------------------------------------------------------------------------------------------o
----------------------------------LLLLL-----------------------------------r------------y-------------------------------------ooo--------!!--g---------
-----------tt------------------------------tt--------oo-------------------%---g-------**----------oo-------------------------ooo--*--------*tt%oo----%
-----tt----tt----LLLL-%%%-----------%%*----tt--r-----oo-*-----------@@---*%%%%---oooo-**--r-----**oo------------tt-g---%%%---ooott*--------*tt%------%
-----tt----tttt------*%%%-----------%%*---*tt%%%-----oo**----*%%%--------*%%%%----tt--**tt------**oo-----*tt----tt%%%--%%%TT----tt*tt------*tt%--@@@@%
M----tt-y--tttt------*%%%--%----y---%%*-k-*tt%%%---y---**%%%%*%%%------k-*%%%%----tt--**tt------**-------*tt----tt%%%--%%%TT----tt*tt-r----*tt%------%
XXXXXXX----XXXX--XXXXXXXX--XXXXXXXXXXXXXXXXXXXXXXXXXXXXXXXXXXXXXXXXXXXXXXXXXXX----XX--XXXXXXXXXXXXXXXXXXXXXX----XXXXX--XXXXXXXXXXXXXXXXXXXXXXXXXXXXXXX
XXXXXXX----XXXX--XXXXXXXX--XXXXXXXXXXXXXXXXXXXXXXXXXXXXXXXXXXXXXXXXXXXXXXXXXXX----XX--XXXXXXXXXXXXXXXXXXXXXX----XXXXX--XXXXXXXXXXXXXXXXXXXXXXXXXXXXXXX
