------------------------------------------------------------------------------------------------------------------------------------------------------
------------------------------------------------------------------------------------------------------------------------------------------------------
------------------------------------------------------------------------------------------------------------------------------------------------------
------------------------------------------------------------------------------------------------------------------------------------------------------
------------------------------------------------------------------------------------------------------------------------------------------------------
------------------------------------------------------------------------------------------------------------------------------------------------------
------------------------------------------------------------------------------------------------------------------------------------------------------
@----oo--SSSS----------------------------------------------------------------ooooo----------@@@@@---------!!!!------------------------oooo-CCC--------
---------------oooooooooo-------------ooo------------------------------------ooooo----------------!!!!!!!-------------ooooo--oooo-----oooo------------
---r----r------oooooooooo----ooo-@--y-ooo--g-------r-------------------------ooooo-------g----------------------------ooooo---------------------------
%---%-%-%---*-k-----*--------ooo--*---ooo%*------*-----*%-----k------r--------------y-S--%----*--------%----------y-----------*----g-----*-*---g-----g
%---%-%-%-%-*-%--%-%*-*----g---%-%*------%*-%----*---%-*%-%---%-%-%--%--*--y-------*-----%-%--*%-------%---%-%-%-%-%--%---*---*%----%--*-*r*---%----*-
%-*-%-%-%-%-*-%*-%-%*%*-*-*%-%-%-%*%-*-%-%*-%----*---%-*%-%---%-%-%--%-%*---%------*---%-%-%--*%---*-*-%-k-%-%-%-%-%--%---*---*%----%--*-*%*---%oooo*%
%-*-%-%-%-%-*-%*-%-%*%*-*-*%-%-%r%*%-*-%-%*-%----*-%-%-*%-%-%-%-%-%--%-%*---%-%--%-*-%-%-%-%--*%-g%*%*-%-%-%-%-%-%-%--%---*-y-*%----%-%*-*%*-%-%oooo*%
XXXXXXXXXXXXX-XXXXXXXXX-XXXXXXXXXXXX-XXXXXXXX-X-XXXXXXXXXXXXXXXXXXX-XX-XX-X-XXX-XX-XXXXXXX-X-XXX-XXXXXXXXXXX-XXXXXXXX-X-X-XX-XXXX-X-XXXX-XXXXXXXX-X-XX
XXXXXXXXXXXXX-XXXXXXXXX-XXXXXXXXXXXX-XXXXXXXX-X-XXXXXXXXXXXXXXXXXXX-XX-XX-X-XXX-XX-XXXXXXX-X-XXX-XXXXXXXXXXX-XXXXXXXX-X-X-XX-XXXX-X-XXXX-XXXXXXXX-X-XX
