------------------------------------------------------------------------------------------------------------------------------------------------------
------------------------------------------------------------------------------------------------------------------------------------------------------
------------------------------------------------------------------------------------------------------------------------------------------------------
--------------------------------------------------SSSSSSS-----------------------ooo-----------------SSSSSSSSSS----------SSS-----SS--------------U-----
--------------------------------------------------------------------------------%%%-------------------------------------------------------------------
---------------------------------------------------------------------------------|----------oo--------------------------------------------------------
-----------------------------U--------------------QQ-----------------------g-----|--------------------------------------US---------------##-----------
-----------------------------------------------------------------------%%%%%%----|-------------------------------------------------------##-------SS--
-----------------------------------------------------------S------------||||-----|-----------------%------------------------SSS--------####-----------
------------Q--?------------------------------------------------1-------||||-----|---%%%%----------------------------------------------####---SS------
-------------------S--------##--------------------QQ--QQQ---------------||||-----|----||--S----------------TT---!-----S-SSS----------######----------#
-----------------------y-#####--------ttT-----TT------------------------||||----%%%%%%||----------------#--TT------------------------######---------##
--------------------y-######----------ttT-----TT------------------------||||-----||||-||-----%%%%------##--TT------------------------######--------###
-M----------------K-######------------ttT-----TT------------------------||||-----||||-||------||----kk-##--TT------------------------######-------####
XXXXXXXXXXXXXXXXXXXXXXXX------XXXXXXXXXXXXXX--XXXXXXXXXXX---XXXXXXXXX---||||-----||||-||%%----||----XXXXX--XX-XXXXXXXXXXXXX------XXXXXXXXXXXXXXXX-XXXX
XXXXXXXXXXXXXXXXXXXXXXXX------XXXXXXXXXXXXXX--XXXXXXXXXXX---XXXXXXXXX---||||-----||||-||-|----||----XXXXX--XX-XXXXXXXXXXXXX------XXXXXXXXXXXXXXXX-XXXX
