------------------------------------------------------------------------------------------------------------------------------------------------------
------------------------------------------------------------------------------------------------------------------------------------------------------
------------------------------------------------------------------------------------------------------------------------------------------------------
------------------------------------------------------------------------------------------------------------------------------------------------------
------------------------------------------------------------------------------------------------------------------------------------------------------
------------------------------------------------------------------------------------------------------------------------------------------------------
------------------------------------------------------------------------------------------------------------------------------------------------------
------------------------------------------------------------------------------------------------------------------------------------------------------
------------------------------------------------------------------------------------------------------------------------------------------------------
------------------------------------------------------------------------------------------------------------------------------------------------------
---------------------------------------------------------------------------tt-------------------------------------------------------------------------
-------------------------------------------------------------------@@------tt-------------------------------------------------------------------------
-------------------------------------tt------------------------------------tt-----------------------------------------------------------------------F-
-M-----------------------------------tt-rrr-----------------------gg-------tt----------------------------------------y------------------------------#-
XXXXXXXXXXXXXXXX-----XXXXXXXXX----XXXXXXXXXXXXXXX---XXXXXXXX-----XXXXXXXXXXXXXXXXXXXXXXXXXXXXXXXXXXXXXXXXXXXXXXXXXXXXXXXX---XXXXXXXXX-----XXXXXXXXXXXX
XXXXXXXXXXXXXXXX-----XXXXXXXXX----XXXXXXXXXXXXXXX---XXXXXXXX-----XXXXXXXXXXXXXXXXXXXXXXXXXXXXXXXXXXXXXXXXXXXXXXXXXXXXXXXX---XXXXXXXXX-----XXXXXXXXXXXX
