------------------------------------------------------------------------------------------------------------------------------------------------------
------------------------------------------------------------------------------------------------------------------------------------------------------
------------------------------------------------------------------------------------------------------------------------------------------------------
------------------------------------------------------------------------------------------------------------------------------------------------------
-----------------------------------------------!!!----------------------------------------------------------------------------------------------------
---------------------------------------------------------------------------------------------------LLLLL----------------------------------------------
---------------------------------------------------------------------------------------CC-------------------------------------------------------------
------------------------------------------------------ooo----------oo---------------------------------------------------------------------------------
-----------------------------@@---------!!--------oo---------------oo----------------------------------------------------@@@@-------------------------
----------------LLL---------r----------g----------oo-k---------------------------SSSSS----------------------------------------------------------------
--------------------tt------*--ooo-%%%-TT------tt-tty%%%%------------------------------%-----LLLLL-%----------oooo--------%%%%---r%-------tt-------ooo
-----------tt------*tt------*%-----%%%*TT-r----tt-tt*%%%%-----!!!!--*--------SSS--%----%-----------%tt--------oooo--------%%%%-CC*%-------tt----------
------tt---tt----%%*tt--oooo*%-*---%%%*TT%%%%*-tt-tt*%%%%-oooo------*--tt---------%----%--ooo------%tt-------------SSSSS--%%%%---*%-------tt--oo-%%%-%
M-----tty--ttg---%%*tt-goooo*%-*---%%%*TT%%%%*ktt-tt*%%%%yoooo----g-*%%tt---k---y-%---r%-y--------g%tt--r---------k-----r-%%%%k--*%--k--g-tt----y%%%-%
XXXXXXXX-XXXX----XXXXX--XXXXXX-XXXXXXXXXXXXXXX-XX-XXXXXXX---XXXXXXXXXXXXX-XXXXXXXXXXXXXX----XXXXXXXXXXX----XXXXXXXX----XXXXXXXXXXXXXXXXXXXXX-XXXXXXXXX
XXXXXXXX-XXXX----XXXXX--XXXXXX-XXXXXXXXXXXXXXX-XX-XXXXXXX---XXXXXXXXXXXXX-XXXXXXXXXXXXXX----XXXXXXXXXXX----XXXXXXXX----XXXXXXXXXXXXXXXXXXXXX-XXXXXXXXX
