------------------------------------------------------------------------------------------------------------------------------------------------------
------------------------------------------------------------------------------------------------------------------------------------------------------
------------------------------------------------------------------------------------------------------------------------------------------------------
------------------------------------------------------------------------------------------------------------------------------------------------------
------------------------------------------------------------------------------------------------------------------------------------------------------
----------------------------------------------------------------------------------------------------------------------------------UUUU----------------
---------------------------------------------------------SSSS------------oo----------UU---------------------------------------------------------------
-------------------------------------------------------------------------oo-------------------------------------------------------------------oooo----
--------------------------------oo----------CCCCC--o------------------------------------ooo----------------------oo-----------------------------------
-------------C------------------oo---------g-----k-o------------LLLLLLLL---g------r-----ooo----------------------oo-----------------------------------
-----r-*-----------------------Coo--------%%%%--%%---ooo------------------TT---tt%%%----ooo--%%%%---------LLL----oor---U------tt-----*----------%%-ooo
-----tt*-%%%%-----------------*-----------%%%%tt%%-------%%%%k------------TT---tt%%%---------%%%%-k----------------%%*--------tt-----*----------%%-ooo
-----tt*-%%%%-----------------*--------*tt%%%%tt%%tt-----%%%%tt----------*TT---tt%%%TT-------%%%%tt----------------%%*--------tt--tt-*-UUUU----*%%-ooo
M---ktt*-%%%%-r-------r-------*--------*tt%%%%tt%%ttg---y%%%%ttg--------y*TT---tt%%%TT-k---y-%%%%tt--------%-------%%*--k-----tt--tt-*y------k-*%%k---
XXXXXXXX-XXXXXXXXXX----XXXXXXXXXXXXXXXXXXXXXXXXXXXXXXXXX-XXXXXXX----XXXXXXXXXXXXXXXXXX-XXXXXXXXXXXXXXXXXXXXXXXXXXXXXXXXXXXXXXXXXXXXX-X-XXXXXXXXXXXXXXX
XXXXXXXX-XXXXXXXXXX----XXXXXXXXXXXXXXXXXXXXXXXXXXXXXXXXX-XXXXXXX----XXXXXXXXXXXXXXXXXX-XXXXXXXXXXXXXXXXXXXXXXXXXXXXXXXXXXXXXXXXXXXXX-X-XXXXXXXXXXXXXXX
