------------------------------------------------------------------------------------------------------------------------------------------------------
------------------------------------------------------------------------------------------------------------------------------------------------------
------------------------------------------------------------------------------------------------------------------------------------------------------
------------------------------------------------------------------------------------------------------------------------------------------------------
------------------------------------------------------------------------------------------------------------------------------------------------------
--------------------------------------------------------CC------------------------------------------------------------------------@@@-----------------
-------------------------------ooo-------------------------ooooo--------------------SS----------------------------------------------------------------
--------------------------CCCCCooo-------------------------ooooo--------------------------------------------------------------------------------------
--------------oooo-------------ooo-LLL-UUUU----------------ooooo---------------------------------------oo---------------------------------------------
--------------oooo------oy---------------------------------------------------------g-------------------oo--------------------------------------o------
-------------------------%%%%----------*----------------tt-*---------oooo----------*---------------ooo----------------LLLL---%%%%%%%%oo--------o------
------------------rk-----%%%%--*-------*-------g-tt-----tt-*%%%%y------------------*%%%*--------------k------------oL--------%%%%%%%%oo----*----------
--------------tt%%%tt--tt%%%%--*-------*---r-%%%%tt----ytt-*%%%%tt-----------------*%%%*--------------%%----------*o--TT-----%%%%%%%%oo----*--------%%
M--------y---ktt%%%tt--tt%%%%--*--r---y*%%%%-%%%%tt-%%%%ttk*%%%%tt-----%---k-----y-*%%%*-----r%%%%y---%%-r------y-*o-kTT%----%%%%%%%%--g---*--g-----%%
XXXXXXX--XXXXXXXXXXXXXXXXXXXX--XXXXXXXXXXXXXXXXXXXXXXXXXXXXXXXXXXXXXXXXX---XXXXXXXXXXXXXXXXXXXXXXXXXXXXXXXXXXXXX--X---XXXXXXXXXXXXXXXXXXXXXXXXXXXXXXXX
XXXXXXX--XXXXXXXXXXXXXXXXXXXX--XXXXXXXXXXXXXXXXXXXXXXXXXXXXXXXXXXXXXXXXX---XXXXXXXXXXXXXXXXXXXXXXXXXXXXXXXXXXXXX--X---XXXXXXXXXXXXXXXXXXXXXXXXXXXXXXXX
