------------------------------------------------------------------------------------------------------------------------------------------------------
------------------------------------------------------------------------------------------------------------------------------------------------------
------------------------------------------------------------------------------------------------------------------------------------------------------
------------------------------------------------------------------------------------------------------------------------------------------------------
-----------------------------------------------------LLL----------------------------------------------------------------------------------------------
-------------------------------------!---------------------------------------------------------------------!!!!---------------------------------------
--------------------------------------oooo----ooooooo--------ooooo---LLL------------------ooo----------------------------------------------------ooooo
--------------------------------------oooo-------------------ooooo---------o--------------ooo----------------------------------------------------ooooo
--------------------------------------oooo---------------------------------o-------ooo----ooo---------------------------------------------------------
--------LLLL--------------------------------------------oooo---------------o-------ooo--------!!!!-------------------------SSSSSSSS-------------------
-----------------------------tt-%%%%-----------%%%--tt-----------------------------ooo-------g---------%%%%---*------y-------------------@@-----------
---------------*-g-----------tt-%%%%-%%%-------%%%--tt------g*---------*--r-y---------------%%%%-------%%%%---*----*-tt----------%-y-----------%%%----
---------------*-*-----*---!!tt-%%%%-%%%---UU--%%%--tt-----tt*-----oo--*--%%%----*----------%%%%-------%%%%---*-C--*-tt----------%%%%%-------tt%%%----
M---r-r--------*-*-----*--g--tt-%%%%y%%%--y--r-%%%--tt-----tt*%%--g----*r-%%%----*----r--g--%%%%--g----%%%%-%%*y-k-*-tt%--y------%%%%%--k--g-tt%%%----
XXXXXXXXXXXXXXXXXXXXXXXXXXXX-XX-XXXXXXXXXXXXXXXXXX--XXXXXXXXXXXXXXXXXXXX--XXXXXXXXX----XXXXXXXXXXXXXXXXXXXX-XXX----X-XXXXXXXXXXXXXXXXXXXXXXXXXXXXXXXXX
XXXXXXXXXXXXXXXXXXXXXXXXXXXX-XX-XXXXXXXXXXXXXXXXXX--XXXXXXXXXXXXXXXXXXXX--XXXXXXXXX----XXXXXXXXXXXXXXXXXXXX-XXX----X-XXXXXXXXXXXXXXXXXXXXXXXXXXXXXXXXX
