------------------------------------------------------------------------------------------------------------------------------------------------------
------------------------------------------------------------------------------------------------------------------------------------------------------
------------------------------------------------------------------------------------------------------------------------------------------------------
------------------------------------------------------------------------------------------------------------------------------------------------------
----------------------SS------------------------------------------------------------------------------------------------------------------------------
------------------------------------------------------------------------------------------------------------------------------------------------------
---------------------------------------------------------------------------------------------------------------------------------!!!!!----------------
----------------------------------------------------------------------------------------------------------------------------LLLLL---------------------
------------------------ooooo-----------------------------------------------CCCCC---------------!!!!--------------------------------------------------
--------------------g---ooooo--r----g--------------------------------------------------------------------U------------------------------g-------------
-------------------tttt-ooooo----tt-------oo---------------oooo---oooooooooo-%%%------!!!!!-----------y-o----------------tt--------%%%%---------CC----
-------------------tttt----%-----tt----SSSoo-------------SS----ooo---ooooo---%%%-----------o------%%%tt-o------@-------tttt-----tt-%%%%------r--------
-----%%%-----------tttttt%%%-----tt--------o-------------------ooo-TTooooo---%%%--------%%-o------%%%tt-o--------------tttt-----tt-%%%%--------%%%%---
M----%%%-----------tttttt%%%-----tt----------------------------ooo-TT--------%%%--------%%---g----%%%tt------r---------tttt-----tt-%%%%--------%%%%--F
XXXXXXXX-------XXX-XXXXXXXXXXXXXXXXXXXXXXXXXXXXXXXXXXXXXXXXXXXX----XXXXXXXXXXXXX--------XXXXXXXX--XXXXXXXXXXXXXXXXXXXXXXXXX-----XX-XXXXXXXXXXXXXXXXXX-
XXXXXXXX-------XXX-XXXXXXXXXXXXXXXXXXXXXXXXXXXXXXXXXXXXXXXXXXXX----XXXXXXXXXXXXX--------XXXXXXXX--XXXXXXXXXXXXXXXXXXXXXXXXX-----XX-XXXXXXXXXXXXXXXXXX-
