------------------------------------------------------------------------------------------------------------------------------------------------------
------------------------------------------------------------------------------------------------------------------------------------------------------
------------------------------------------------------------------------------------------------------------------------------------------------------
------------------------------------------------------------------------------------------------------------------------------------------------------
----@---------------------------!L-------U----------C-----------------------------------------------------------------L-------2--!--------------L-----
----------------------------------------------U------o-------------------------------------------------------------------L------------@---------------
-L----------------------------------------------U---------------C1----------------------------------2-------------L-----------------------------------
-----------L!-----------------------------C--------L@----------------------------------------------------------U---!--U----------------------------U--
-------------------------------------------------------1--------------------------@-----------@--------------------------!---2------------------------
----------1---------------------------------o-------o------------------------L-------------L-----C---C---------------------------------------L--------
----------!-----1-------------1--------------------------------------------------------------o--C-----------------------------------------------------
-k------------#----#-g---K--#--G-k-------#------#-#gr-r##----------#-g-------------y---#Y-#--#-#----G--------------------#---kr--#--------g--------#k-
--K-----g-----y----Y-###--#-------k-g----------g-k-#---K---#----r--r----##-----------K-----ry-------#--##--G-##---------------#---y----------G-----k--
-M----Ry--------K-------------g----g-g#--------gG----------#-Y----------K----------r-----G-k-#------------#-------#-----#------#-----------------k--F-
XXX----X--X---X-X--X--X----X--XXXX-X--XXX---X-X---------X-X--X--X-XX-X--X--X-X-XX-X--XXXX-XXXX---X---X---X-X-X--X-X---X----X----X---X-X--X---XX--XXXXX
XXXXX-X--X-X------XX--X----X---XXX-----XX----XXXX-X--X---XXX--XX---XX--X-X--XX--X---X--X--X-X---------XX---XXXXX--X----X-----X-XX-XX-----X--X--X--XXX-
