------------------------------------------------------------------------------------------------------------------------------------------------------
------------------------------------------------------------------------------------------------------------------------------------------------------
------------------------------------------------------------------------------------------------------------------------------------------------------
------------------------------------------------------------------------------------------------------------------------------------------------------
------------------------------------------------------------------------------------------------------------------------------------------------------
---------------------------@@@@@-----------------------------@@@------------------------------------------------------------LLLLL---------------------
---------------------------------------------------------LLLL-----------------------------------------------------------------------------------------
----------------------------------------------------------------ooooo---------------------------------------------------------------------------------
-----UUU------------------------------------------------------------------------------------------------------------------------------CS----@@--------
------------------!!!!-------------------------------------------------k------------------oooo----------ooooo----ooo-------o--------------------------
-----------------------------%%%--------------k-------ooo----%%---tt%%-----y-!C-----------ooo---g-------ooooo----ooo-----y-o------------oooo----------
------------------------r----%%%----------ttTT--------ooo----%%tt-tt%%%--tt-------------r--tt--tt----k-----------ooo-----%%tt-----------oooo----tt----
-----------%%%--k--------TT--%%%----------ttTTtt------------%%%tt-tt%%%--tt--------------tttttttt----%---------g---------%%tt%%%--------oooo----tt----
M----------%%%%%%--------TT--%%%----------ttTTtt--g---------%%%tt%tt%%%--tt--------------tttttttt----%---%%%---%%%----r--%%tt%%%----r-----------tt---F
XXXXX------XXXXXX--------XX--XXXXXXX------XXXXXXXXXXXXXXXXXXXXXXXXXXXXX--XXXXXXXXXXXXXXXXXXXXXXXXXXXXXXXXXXXXXXXXXXXXXXXXXXXXXXXXXXXXXXXXXXXXX--XX----
XXXXX------XXXXXX--------XX--XXXXXXX------XXXXXXXXXXXXXXXXXXXXXXXXXXXXX--XXXXXXXXXXXXXXXXXXXXXXXXXXXXXXXXXXXXXXXXXXXXXXXXXXXXXXXXXXXXXXXXXXXXX--XX----
