------------------------------------------------------------------------------------------------------------------------------------------------------
------------------------------------------------------------------------------------------------------------------------------------------------------
------------------------------------------------------------------------------------------------------------------------------------------------------
------------------------------------------------------------------------------------------------------------------------------------------------------
-----------C------------!-----------------------------!------------o---2--------------------------C--------------U------------------------------------
-2-L-----------------------------L--------o-2----------L-----------1------------------------------------------L-----------2-----@----------!-----@----
-!---U---------------L-------------2-------------------------------------------2------------U-----------1--------------L-----------------------------C
-------1------------------------------o-----L----------------------------------------L------------------C--------------------@------------------------
-------------L----oU-------L---------------------------o--U-----!--------L-----------o---------------------C------------------------------------------
------------!-------------------L-----------------------------------------------------------------------------L---------------!-----------------------
-------o--------@---o---------------2---------1-----------@-----------------------L----------------------@o----o------------------C---o---------------
----#-------------#g----G--rRk#-----g------#-------------------g------yg-#----#------r-#--G#-#-#-k------#-#---k#--------K------g#---G-----#----#------
y#-------K-----#--#------#g--#----------Y----k-#------------------##r-#--------#--R-------#------#--##------R-------#------k--#---g---#-----#--#-----#
-M----R#-#-#--y#---#------r--------#--K----------------R-----#Y#---r----g-----y--#-------#----------------#--#---#-------#------------------y-G-----F-
XXXXX------X-XXX-----XX-X--X----XX--XXXXXX-----X---X--X----XX-XX-XX-XXX-X-XXXX-----XXXXX---X-X----X-X-XX-------X----XX--X-XX-----XX--XX-X------X-XXXX-
XXX-XXXX------XXX-X-X-------XX--XXX--X---XXXX------X-----------X--X-XX-XX-----XXX----X-X-XXXX-X-X-X--X----X-X-X-XX-X----X-X----X-X---X-XX-X----X--XXXX
