------------------------------------------------------------------------------------------------------------------------------------------------------
------------------------------------------------------------------------------------------------------------------------------------------------------
------------------------------------------------------------------------------------------------------------------------------------------------------
------------------------------------------------------------------------------------------------------------------------------------------------------
----------------------o--------------------------------------------------------1--2---------------o---------------------------------------------------
----------L-----------------2--------------------L----------C--------------------2----@----------------------------------U----------------------------
-----------------------!--------------------C-----------1---1!-------------1--------------------------------------------C-----------------------------
---@---------------C---------C----------------2------------o-----------------------------------------------------------------U------------------------
-----------o-------------------2-----------------------U@!--1---------o---------------C-----------------------------------C---------------------------
----------------------------------------@------------------------------------------------------@-o---C---------C--------------------o--@--------------
-------------------------------L-U--------------------C------------2----------------1-------------------C----------------------------@----------------
--k--y-Y------#--------#----------#k--------Yy--#---k-------------#g-----------#--#---y--#-------R----------------------#--------------------------#--
--------------#---------y---------r#Y-#-y---------#-#---#-----------------------##-##--------------r--G-#---------y-#---#----#----#---#--R------#-----
RM------#---r---g--------#-----------K--------##Y---g-Y-----R--------g----#gg--###------R----kK#rY-------g-y-Y-----K---#----#--k-#------#--------#--F-
XXXXXXXXXXXX--XX-X---X----XX-----XX---X--XXX-X------XX--XX-X-XX-XX-X-X-XX----XXX----XX-X--X---X--XXX-X-------XX-X------X-X---X-X---------XX-XX-XXXXXX-
XXXX-XX---X-----XX-X-----------XX---XXX--X-X----XX---X-------X-XX-XXXX---X-XXX-X---XXX--X-XXXX-X---X-XX--X-X-XX-XX-----XX--XXX--XX--X--X---X----X-XXX-
