------------------------------------------------------------------------------------------------------------------------------------------------------
------------------------------------------------------------------------------------------------------------------------------------------------------
------------------------------------------------------------------------------------------------------------------------------------------------------
------------------------------------------------------------------------------------------------------------------------------------------------------
------------------------------------------------------------------------------------------------------------------------------------------------------
------------------!!!--------------------------------LLLL---------------------------------------------------------------------------------------------
---------------------------------------------------------------------------ooooooo--------------------------------------------------------------------
-------------------------------------------------!!!!----------------------ooooooo--------------------------------------------------------------------
---------------------------------------------------------------------------ooo----ooo---------------------------------------@@@@@---------------------
----------------------------------------------------------------------------------ooo-----------------k---------------------------------------CC------
-----ooooo-oooo-y----------%-------oo----S---------tt--%%%----UUUUU-%-----!tt---tt---------------------%--------------%%%-----------------------o-----
-----oooooC-----%%%%-------%-----------k-----------tttt%%%----------%------tt---tt---------------------%--k-----------%%%tt---%%%------r--------o-----
-----ooooo------%%%%---tt--%%---tt------tt---------tttt%%%----------%-----%tt---tttt-------------------%--%%S---------%%%tt---%%%---%%----------o-----
M----tt%%%%%%---%%%%---tt--%%---tt------tt---------tttt%%%--------%%%---r-%tt---tttt--------------k----%--%%----------%%%tt---%%%---%%-----k---------F
XXXXXXXXXXXXXXXXXXXX---XX--XX---XXXXX---XXXXXXXXXXXXXXXXXX-----XXXXXXXXXXXXXXXXXXXXX--XXXXXXXXXXXXXXXXXX--XX----XXXXXXXXXXX---XXX---XX-XXXXXXX---XXXX-
XXXXXXXXXXXXXXXXXXXX---XX--XX---XXXXX---XXXXXXXXXXXXXXXXXX-----XXXXXXXXXXXXXXXXXXXXX--XXXXXXXXXXXXXXXXXX--XX----XXXXXXXXXXX---XXX---XX-XXXXXXX---XXXX-
