------------------------------------------------------------------------------------------------------------------------------------------------------
------------------------------------------------------------------------------------------------------------------------------------------------------
------------------------------------------------------------------------------------------------------------------------------------------------------
------------------------------------------------------------------------------------------------------------------------------------------------------
--------------C----------------------------------------------oo----------------------------------------------------2-------------!----------!---------
-------@---------!------@-----U-------------------------------------------------@------------o--------------2-----------------------------------------
----------------------------2------------------------------------------------------------@-----------------U----------------------------------o----C--
-------------1-----------------------2-------C--------------------------o-------1-o----------------------------------------------------------------o--
------------1----------------------@------------------------------------------------------------U---------------------C-------------------!-----------
----------2---------------------------L---------------------------------------------------------1-1-----------------------L-----------------!-------1-
----------L--------------@----------------------------------------------------------------------o--------------o--1---L------------2-C----L-----------
#--------R-#---#----##---#---k--k---#G-----------------k------#---G--------#-#---#---------K--R---#-----------#-----Y-----------------r-k------------K
--#--R#-------y#---Rk--------#---K--r----r-K------g--------------------Y-------#r---#------------#-r----------------------------#------Y#----#-----##-
YM-Rk#---y-----#-------g--------Y------------#----#---------R-------#-----g#-#-------------Y--k---r----Y---R----g-----yR----y------------#-----Y----F-
XXXX-----XX-X-X--XX--X--X-X-X-X-X----X---XXX--X----XX------X---XX---X-XXX--X-----XX-XX--X---X--X---X-XX-X-X--XXX--X-------XX-----XXX-X--X-XXX-XX--XXX-
XXX-X---X-XX-X-XXXXX---XX-X-X-XX--X--X--XXX--X-XX---X----X-X--X---XXXX----X-X-XXX-XX------X-X-----XX-X-XXX--------X--X-XX------XX--XXXX---XX------XXX-
