------------------------------------------------------------------------------------------------------------------------------------------------------
------------------------------------------------------------------------------------------------------------------------------------------------------
------------------------------------------------------------------------------------------------------------------------------------------------------
------------------------------------------------------------------------------------------------------------------------------------------------------
-----@@@@@---------------------------------UUUUU------------------------------------------------------------------------------------------------------
------------------------------------------------------------------------------------------------------------------------------------------------------
------------------------------------------------------------------------------------------------------------------------------------------------------
----------ooooo--------SS------------------------------------------------------------------------------------------------LL---------------------------
----------ooooo------------------------------------------------SS-------------------------------------------------------------------------------------
------------------L--------k----------------------r---------y-------------------------LLLL-----------S-----------------r------------------------------
--------%--%------------%%----k-----!!!!-------tt----------%%%o-----ooooo-----------------------------------------------tt--------------%%------!!!!!-
--------%tt%tt----------%%----tt---------------tt----------%%%o--!!!--------------UL--------g---------------------------tt--y------tt---%%TT----------
--------%tt%tttttt---r--%%tt-%ttSSSS-----y---tttt----------%%%o-------tt---------------------%%%%-----ooo---------------tt%%%---%%%tt---%%TT%%tt------
M----%%%%tt%tttttt%%----%%tt-%tt---------%%%-tttt%%%%------%%%--------tt--k-----------%%-----%%%%-----ooo--g----------%-tt%%%---%%%tt---%%TT%%tt-----F
XXXXXXXXXXXXXXXXXXXX----XXXX-XXXXXXXXXX--XXX-XXXXXXXXXXXXXXXXXXXXXXX--XX-XXXXXXXX-----XXXXXXXXXXXXXXXXoooXXX----XXXX--X-XXXXX---XXXXX---XXXXXXXX------
XXXXXXXXXXXXXXXXXXXX----XXXX-XXXXXXXXXX--XXX-XXXXXXXXXXXXXXXXXXXXXXX--XX-XXXXXXXX-----XXXXXXXXXXXXXXXXXXXXXX----XXXX--X-XXXXX---XXXXX---XXXXXXXX------
