------------------------------------------------------------------------------------------------------------------------------------------------------
------------------------------------------------------------------------------------------------------------------------------------------------------
------------------------------------------------------------------------------------------------------------------------------------------------------
------------------------------------------------------------------------------------------------------------------------------------------------------
------------------------------------------------------------------------------------------------------------------------------------------------------
------------------------------------------------------------------------------------------------------------------------------------------------------
------------------SSS------------------------------------------o----------------------------------@@@@@-----------------------!!----------------------
---------------------------------------------------LLLLL-------o--------------------------------------------------------------------------ooo---------
------------------------------------!!!ooooo----!!!------------o-------------------------ooo----------------------------------------------ooo---------
oooo--------------------g-CC-----------ooooo----------------k-----------CCCCC--C---------ooo----------------------------------------------ooo---------
oooo------------*--tt--%*---------------------g--------------tt------------------------------------------%%%%---------------g-------------------------
ooooo-----------*--tt--%*%%%%----------------**-------*------tt*------UU-------------------------tt------%%%%-*-------------%%%---------tttt----------
----------------*--tt--%*%%%%*---------tt%%%%**----tt-*------tt*--------%-------LLLLL----%%tt----tttt%%%%%%%%-**--------ooo-%%%tt-------tttt----------
M------g---y----*--tto-%*%%%%*%%%------tt%%%%**%%--tt-*------tt*--r-----%--------------y-%%tt----tttt%%%%%%%%-**%%%--k--ooo-%%%tt-------tttt---r------
XXXXXXXXXXXXXXXXX--XX--XXXXXXXXXX------XXXXXXXXXX--XX-XXXXXXXXXXXXX-----X-----XXXXXX--XXXXXXX----XXXXXXXXXXXX-XXXXXXXXXXXX--XXXXX----XXXXXXX----XXXXXX
XXXXXXXXXXXXXXXXX--XX--XXXXXXXXXX------XXXXXXXXXX--XX-XXXXXXXXXXXXX-----X-----XXXXXX--XXXXXXX----XXXXXXXXXXXX-XXXXXXXXXXXX--XXXXX----XXXXXXX----XXXXXX
