------------------------------------------------------------------------------------------------------------------------------------------------------
------------------------------------------------------------------------------------------------------------------------------------------------------
------------------------------------------------------------------------------------------------------------------------------------------------------
------------------------------------------------------------------------------------------------------------------------------------------------------
------------------------------------------------------------------------------------------------------------------------------------------------------
-----------------------ooo-----------------------SSS-----------------------------------------------------------------------------------------CCC------
-----------------------ooo----------------------------------------------------------------------------------------------------------------------------
----------ooooo-----ooo-----------ooUUUU--------------------------------------------------------------------------------------------------------------
--------------------ooo-----------------------------o------------CCCCC-----------@@-----------------------------------------------------------------SS
--------UU-----oooooooo------------------------k----o----------------------------------------------------@@@@--r--------------------------------------
CCCC------*----ooooott%%%%--------**%%----y----%----o-------------tt-----------------------tt---LLL-----------*-----------------------%%---tt-----r---
----oooo--*%%-------tt%%%%--------**%%---tt----%---tt-------------tt%%---------------------tttt--------------**----------------oo-----%%--otttt--%%---
----oooo--*%%-------tt%%%%!!------**%%%%-tt----%---tt--*----------tt%%-------%%%%--------tttttt-------*------**------%%--------oo-----%%--otttttt%%---
M---oooo--*%%-------tt%%%%--------**%%%%-tt----%---tt--*----------tt%%-------%%%%--------tttttt-------*------**------%%-----r--oo-----%%---tttttt%%---
XXXXXXXX--XXXXXXXXXXXXXXXXXXXXXXX-XXXXXX-XX----X---XX--XXXXXXX----XXXXXXXXXXXXXXXXXXXXXXXXXXXXXXXXXXXXX-XXXXXXXXXX---XXXXXXXXXXXXXXXXXXXXXXXXXXXXXXXXX
XXXXXXXX--XXXXXXXXXXXXXXXXXXXXXXX-XXXXXX-XX----X---XX--XXXXXXX----XXXXXXXXXXXXXXXXXXXXXXXXXXXXXXXXXXXXX-XXXXXXXXXX---XXXXXXXXXXXXXXXXXXXXXXXXXXXXXXXXX
