------------------------------------------------------------------------------------------------------------------------------------------------------
------------------------------------------------------------------------------------------------------------------------------------------------------
------------------------------------------------------------------------------------------------------------------------------------------------------
------------------------------------------------------------------------------------------------------------------------------------------------------
------------------------------------------------------------------------------------------------------------------------------------------------------
---ooooooooo------------------------------------------------------------------ooooo------------------------------------------------------------SSSSS--
---ooooooooo-------------------------------------------------------------LLLLLooooo-LL---------UUUU---------SSSS-----------LLL----------ooo--oo-------
---ooooooooo-------!!!-ooooo---------------------ooooooooLL-------------------ooooo-----------------------------------------------------ooo-----------
-------------------------------------------------oooooooo--------------------------------------------------------!!!!--------------ooo----------------
--------------r---r-------------r----------r----------------kooo-r-oooo-----------------------------------------g---------------r--ooo-r----r---------
o-r---------%---%-*--%--------*--------%---tt---g------*----%-*--*------y----*----%---%*-%-g--------------k---%-*--*-k---*--------tt--*----%--*-*-*---
%-%----%*-%-%*--%-*--%-*---*--*--%---*-%---tt--%---%---*----%-*--*-----%*-*--*-%-*%-%-%*-%*-*----*--g-----%---%-*--*-%-*-*-%-*---*tt%-*--*-%--*-*-*---
%-%----%*-%-%*--%-*--%-*-*-*--*--%-*-*-%---tt--%---%-*-*-%*-%-*--*----*%*-*-%*-%-*%-%-%*-%*-*---%*--%*---*%---%-*--*-%-*-*-%-*--%*tt%-*-%*-%*-*-*-*--r
%-%----%*-%-%*--%-*--%y*-*-*--*--%-*-*-%---tt--%-%-%-*-*-%*-%-*--*----*%*%*-%*-%-*%y%-%*-%*%*-%-%*--%*%--*%---%-*--*-%-*-*-%-*--%*tt%-*-%*-%*-*-*-*-%-
XXXX-X-XX-X-XXX-XXX-XX-XXXXXX-XX-X-XXX-XX-XXX-XXXX-XXXXXXXX-XXX-XXX-X-XXXXX-XXXX-XXXXXXXXXXXX-XXXXX-XXXX-XXX-XX-XX-X-XXX-XXX-XX-XXXXXXX-XXXXX-XXXXXXXX
XXXX-X-XX-X-XXX-XXX-XX-XXXXXX-XX-X-XXX-XX-XXX-XXXX-XXXXXXXX-XXX-XXX-X-XXXXX-XXXX-XXXXXXXXXXXX-XXXXX-XXXX-XXX-XX-XX-X-XXX-XXX-XX-XXXXXXX-XXXXX-XXXXXXXX
