------------------------------------------------------------------------------------------------------------------------------------------------------
------------------------------------------------------------------------------------------------------------------------------------------------------
------------------------------------------------------------------------------------------------------------------------------------------------------
------------------------------------------------------------------------------------------------------------------------------------------------------
------------------------------------------------------------------------------------------------------------------------------------------------------
------------------------------------------------------------------------------------------------------------------------------------------------------
-----------ooooo------------------------@-------------------------------------------------------------------------------------------------------------
-----------ooooo-------oooo---------!!!!-------------CCCC---------------------------------------------------------------------ooooooooo---------------
-------------------CCCCoooo---------------------ooooo---------------------------------------------------------------!!!-------ooooooooo---------------
---------------------------------------------------------------------------------------------------------------ooooo-----g----------------------------
-------------*-----------------%--------------o-----%%%%-----------------------tt----------------*----------------------*---k--------------------*----
-------y----%*--ooo-----TT-----%*-----tt*-------*---%%%%-------------o---------tt-*--o---------tt*------S-----------tt--*-%%%%-------------------*----
--y----%%%%%%*--ooo-----TT---tt%*-----tt*--SSS--*%%%%%%%-U------%%%%-oooooo-tt%tt**------------tt*---------------*--tt--**%%%%tt-----%%%tt----%%%*----
M------%%%%%%*--ooo-----TT---tt%*-----tt*-------*%%%%%%%--------%%%%-o------tt%tt**-----y------tt*----r----------*--tt--**%%%%tt-----%%%tt---%%%%*----
XXXXXXXXXXXXXX---XXXXXXXXXXXXXXXX-----XXXXXXXXXXXXXXXXXXXXXXXXXXXXXXXXXXXXXXXXXXXXXXXXXXXX-----XXX---XXXXXXXX----X--XX--XXXXXXXXXXXXXXXXXXXXXXXXXX----
XXXXXXXXXXXXXX---XXXXXXXXXXXXXXXX-----XXXXXXXXXXXXXXXXXXXXXXXXXXXXXXXXXXXXXXXXXXXXXXXXXXXX-----XXX---XXXXXXXX----X--XX--XXXXXXXXXXXXXXXXXXXXXXXXXX----
