------------------------------------------------------------------------------------------------------------------------------------------------------
------------------------------------------------------------------------------------------------------------------------------------------------------
------------------------------------------------------------------------------------------------------------------------------------------------------
------------------------------------------------------------------------------------------------------------------------------------------------------
------------------------------------------------------------------------------------------------------------------------------------------------------
----------------------------------------------------------------------------------------------------------------CCC-----------------------------------
----------------------------------------------------------------------------------------------UUUU----------------------------------------------------
------------------------------ooo---------------------------------------------------------------------------------------------------------------------
------------------------------ooo-------------------ooooS----------------!!!!---------------------oo---------@-----!!!!!------------------------------
------------------------r---y-----------------------oooo------------------------------------------oo-------------------------ooo----------------------
------%*---%%%--o-----*---**-------------------ooooo---%%-tt-----------tt-------------------------oo--------------%%%-----k--ooo------%%%-*--*--------
------%*-tt%%%--o-----*---**-----ooooo------------tt%%-%%-tt-*---tt----tt%%%%------------------------------k------%%%---*%%--ooo-----%%%%**--*--------
--k---%*-tt%%%---CCCUo*tt-**%%%%*ooooo*-------%%%%tt%%*%%*tt%*%%%tt----tt%%%%SSSSS-------LLLoo--*-----------%%----%%%---*%%-o--------%%%%**-%*------k-
M-----%*-tt%%%-------o*tt-**%%%%*ooooo*-------%%%%tt%%*%%*tt%*%%%tt%%%%tt%%%%---------r-----oo--*-----y-----%%----%%%---*%%------%%%%%%%%**-%*---g-%%%
XXXXXXXX-XXXXXXXXXXXXXXXX-XXXXXXXXXXXXX-------XXXXXXXXXXXXXXXXXXXXXXXXXXXXXXXXXXXXXXXXXXXXXXXXXXXXXXXXXXXXXXXX----XXXXXXXXXXXXXXXXXXXXXXXXX-XXXXXXXXXX
XXXXXXXX-XXXXXXXXXXXXXXXX-XXXXXXXXXXXXX-------XXXXXXXXXXXXXXXXXXXXXXXXXXXXXXXXXXXXXXXXXXXXXXXXXXXXXXXXXXXXXXXX----XXXXXXXXXXXXXXXXXXXXXXXXX-XXXXXXXXXX
