------------------------------------------------------------------------------------------------------------------------------------------------------
------------------------------------------------------------------------------------------------------------------------------------------------------
------------------------------------------------------------------------------------------------------------------------------------------------------
------------------------------------------------------------------------------------------------------------------------------------------------------
------------------------------------------------------------------------------------------------------------------------------------------------------
---------------------------------------------------------------------------------------------------UUUUU------------!!!!!UUUU--------------------ooooo
---------------------------------------------------------------------CCC----------------------------------------------------------------------oooooooo
-----------ooo--------CCCCC---------------------------------------------------------------------------------------------------------------------------
-----------ooo-------------------------------------@---------------------------------------------------------!!!--------------------------------------
-----------ooo------------------------------------------------UUU--oo-------------@@----------UUUUU----------------------------------SSSSS------------
-------------------y---------------------------o----@--------------oo-------------------*-----------------------------------------tt------------tt----
------------%%-r--tt---tt*----y----------------o-----------------oo-tt%---k--------*----*----------%%%------------g-tt%%%%--------tt------o-g---tt-%%%
-g----------%%%%%%tt%%%tt*tttt--oo----tt--------ooo--------k--------tt%%%%%--ooooo-*----**---------%%%----------%%%%tt%%%%----*---tt------o*----tt%%%%
M-----------%%%%%%tt%%%tt*tttt--------tt-----k--ooo----------%%%%---tt%%%%%--ooooo-*-g--**---------%%%----------%%%%tt%%%%----*---tt------o*----tt%%%%
XXXXX---XXXXXXXXXXXXXXXXXXXXXXXXXXXXXXXXXXXXXXXXXXXXXXXXXXX--XXXX---XXXXXXXXXXXXXX-X----XXXXXX-----XXX--XXXX----XXXXXXXXXX----X---XXXXXX---X----XXXXXX
XXXXX---XXXXXXXXXXXXXXXXXXXXXXXXXXXXXXXXXXXXXXXXXXXXXXXXXXX--XXXX---XXXXXXXXXXXXXX-X----XXXXXX-----XXX--XXXX----XXXXXXXXXX----X---XXXXXX---X----XXXXXX
