------------------------------------------------------------------------------------------------------------------------------------------------------
------------------------------------------------------------------------------------------------------------------------------------------------------
------------------------------------------------------------------------------------------------------------------------------------------------------
------------------------------------------------------------------------------------------------------------------------------------------------------
----------------------------------------------------------------------------------------------------------------------------------------------!!!-----
------------------------------------------------------------------------------------------------------------------------------------------------------
---------UUUU----@@@@@-----------------UUooo----------------------------------------------------------------------------------------------------------
-----------------------------------------------------------------------------------------------------------------oooo---------------------------------
-----------------------------------------------------oooo---------------------------------------------------LLLLL-------------------------------------
-------------oo--------------------------------------oooo----------------------ooo---UU------------------------------LLL----------o--------------o----
------------------%%-----tt------------*--%-ooooooooooooo-------------o--------ooo----------------------------------*-------k-----o-----------*-------
--------tt----*!!-%%-----tt-------tt---*--%-oooo----------------------o-----------SSS-----------%%------------------*tt----tt-----o---------r-*-------
oo------tt----*---%%-----tt-------tt---*%%%-oooo%%%--------------%%%tto-------------------------%%------------------*tt-LLLtt-LLLL-!!!-----*tt*-------
M---g---tt%%%%*---%%-----tt-------tt---*%%%-----%%%--------k-----%%%tt-------------------g------%%--y---------%%%%%%*tt----tt-----------g--*tt*%%%----
XXXXXXXXXXXXXXX---XX-----XXXXXXXXXXX---XXXXXXXXXXXXXXXXXXXXXXXXXXXXXXX-XXXXXX----XXXXXXXXXXX----XX---XXXXXXX--XXXXXXXXX----XXXXXXXXXXXXXXXXXXXXXXXXXXX
XXXXXXXXXXXXXXX---XX-----XXXXXXXXXXX---XXXXXXXXXXXXXXXXXXXXXXXXXXXXXXX-XXXXXX----XXXXXXXXXXX----XX---XXXXXXX--XXXXXXXXX----XXXXXXXXXXXXXXXXXXXXXXXXXXX
