------------------------------------------------------------------------------------------------------------------------------------------------------
------------------------------------------------------------------------------------------------------------------------------------------------------
------------------------------------------------------------------------------------------------------------------------------------------------------
------------------------------------------------------------------------------------------------------------------------------------------------------
------------------------------------------------------------------------------------------------------------------------------------------------------
------------------------------------------------------------------------------------------------------------------------------------------------------
-------------------------------LLL--------------------------------------------------------------------------------------------------------------------
--------------U-------------------------------------ooo--------------------------SS-------------------LLLLL-------------------------------------------
----------------------------------------------------ooo---------------------CCCCC---------------------------------------------------------------LLLL--
----CCCCC-------k-oo----UUUUU----------------r-----------ooo--------------------------------r---y--ooo------------------------------------------------
--------------TT--oo----------%%%----r------*---------*--ooo--------%%%------tt--tt--------tt*-tt--ooo--------%%%%------------------------------*-----
----tt--------TT--------------%%%---%%------*---------*ooooo----tt--%%%------tt--ttoooo-r--tt*-tt-oooo----*---%%%%-------------*--------tt------*-----
----tt*--ooo--TT--------tt----%%%---%%------*-------tt**--------ttTT%%%------tt--tt------%%tt*-tt--------**---%%%%--------*----*--------tt------*-----
M---tt*--ooo--TT------k-tt----%%%---%%------*-------tt**-----r--ttTT%%%--k---tt--tt------%%tt*%tt--------**---%%%%-----r--*----*---y----tt------*----r
XXXXXXXXXXXXXXXXXXXXXXXXXXXXXXXXX---XX------XXXXXXXXXXXXXXXXXXXXXXXXXXX-XXXXXXX--XXXXXXXXXXXXXXXXXXXXXXXXXX---XXXXXXXXXXXXX----XXXXXXXXXXXXXXXXXXXXXXX
XXXXXXXXXXXXXXXXXXXXXXXXXXXXXXXXX---XX------XXXXXXXXXXXXXXXXXXXXXXXXXXX-XXXXXXX--XXXXXXXXXXXXXXXXXXXXXXXXXX---XXXXXXXXXXXXX----XXXXXXXXXXXXXXXXXXXXXXX
