------------------------------------------------------------------------------------------------------------------------------------------------------
------------------------------------------------------------------------------------------------------------------------------------------------------
------------------------------------------------------------------------------------------------------------------------------------------------------
------------------------------------------------------------------------------------------------------------------------------------------------------
------------------------------------------------------------------------------------------------------------------------------------------------------
--------------------oo--------------------------------------------------------------------------------------------------------------------------------
--------------------oo--------------------------------------------------------------------------------------------------oo----------------------------
-------S----------------------------ooooo---ooooo-----------------------------------------------------------------------oo@@@-------------------------
------------------------------------ooooo---ooooo----------CCU----------------------------------------------------------oo----------------------------
------------------y-------------!!!!--------ooooo-------------------------------------------------------------------------------------k---------------
-------%-----------tt*-tt------------------------------------%----------------------*---ooo-----------------------------------------*-------r------tt-
-------%oooo!!!!---tt*-tt--------------ttooo-----tt%*--------%------------------!!!-*-g-ooooo----------%-------------------%--------*--------tt----tt-
-------%oooo-------tt*-tttt%%%%tt%%-%%-ttooo---tttt%*--------%*---------!!!!!------U*%--ooooo---------*%--------------*-*tt%tt*%%---*%--CC---tt----tt-
M----r-%oooo-------tt*-tttt%%%%tt%%-%%-tt------tttt%*----r---%*---------------------*%-----oo-r-------*%--------------*%*tt%tt*%%---*%-------tt----ttr
XXXXXXXXXXXXXXXXXXXXXX-XXXXXXXXXXXX-XX-XX------XXXXXX----XXXXXXXXXXXXXXXXXXXXXXXX---XXXXXXXXXXXXXXXXXXXX--------XXXXXXXXXXXXXXXXXXXXXX-XXXX--XX----XX-
XXXXXXXXXXXXXXXXXXXXXX-XXXXXXXXXXXX-XX-XX------XXXXXX----XXXXXXXXXXXXXXXXXXXXXXXX---XXXXXXXXXXXXXXXXXXXX--------XXXXXXXXXXXXXXXXXXXXXX-XXXX--XX----XX-
