------------------------------------------------------------------------------------------------------------------------------------------------------
------------------------------------------------------------------------------------------------------------------------------------------------------
------------------------------------------------------------------------------------------------------------------------------------------------------
------------------------------------------------------------------------------------------------------------------------------------------------------
------------------------------------------------------------------------------------------------------------------------------------------------------
---------------------------SSSS-------CCCCC-------------------------------------------------------------------------------------------@@@-------------
-----------ooooooo----------------------------CCCC-----------------------------@@@@@---------------------CCCC-----------------------------------------
oooooooo---ooooooo------------------------------------------------------------------------------------------------------------oooo-----------ooooo----
oooooooo------------------------------------------------------------oooooo-------------SSSSSSSSSS-----------------------------oooo-----------ooooo----
---------g----------------g---------y-----------------ooo-----------oooooo-----------g--------------------------------------r-------k------g-ooooo--g-
-------*--*----------g---%--*-----*%-%--------%-----y-----y-----k---oooooo--g------%-*---%------------%--%---oo-------%*%--%--------*------%------*---
-------*--*-----*--%-----%--*-----*%-%--*-%-k-%--*-*---%*%*-----%-*-------%*-----%-%-*---%---*-----y--%--%-*-*%---y---%*%*-%--------*--*---%------*-*-
-%-%-*-*--*-----*-*%---%L%--*-%-*-*%-%--*-%*--%*-*-*--*%*%*---*-%-*--*-*--%*--*--%-%-*---%*--*-%-%----%--%-*-*%---*---%*%*-%*-tt--%-*--*---%*%*--%*%*-
M%-%-*-*--*%-%--*-*%---%-%--*-%r*-*%-%--*-%*%-%*-*-*-%*%*%*-%-*-%-*--*-*--%*--*--%-%-*---%*--*-%-%----%--%-*-*%---*-%-%*%*-%*-tt--%-*--*%--%*%*--%*%*-
XX-XXX-X-XXXXX-XXXXXX-XX-X-XX-XXXXXXXX-XX-XXX-XXXXXXXXXXXXXXX-X-XXX-XX-X-XXX-XXX-XXX-XX-XXXX-X-XXXX-X-X-XX-X-XX-XXX-XXXXXXXXXXXX-XX-X-XXXX-XXXX-XXXXX-
XX-XXX-X-XXXXX-XXXXXX-XX-X-XX-XXXXXXXX-XX-XXX-XXXXXXXXXXXXXXX-X-XXX-XX-X-XXX-XXX-XXX-XX-XXXX-X-XXXX-X-X-XX-X-XX-XXX-XXXXXXXXXXXX-XX-X-XXXX-XXXX-XXXXX-
