------------------------------------------------------------------------------------------------------------------------------------------------------
------------------------------------------------------------------------------------------------------------------------------------------------------
------------------------------------------------------------------------------------------------------------------------------------------------------
------------------------------------------------------------------------------------------------------------------------------------------------------
------------------------------------------------------------------------CCCC--------------------------------------------------------------------------
------------------------------------------------------------------CCC---------!!!!!-------------------------------------------------------------------
-------------------------------------------------------------------------------------------C----oooo--------------------------------------------------
-------------------------------------ooo--------oooo--------------------------------------------oooo--------------------------------------------------
-------------------------------------ooo--------oooo-oooo---------------------------------------oooo-----------------oo-------------------------------
--ooooo----------------------------g-ooo--k-----oooo-oooo----g--------g------g----------------k------g-oooo---------k--------S---------k----------y---
--ooooo--k-----------k-------------*-----*-*------------------%----%---%*----*-%---------g-*-%--------*oooo%---y---%*-----r----k--------%-*------*--%-
----------*----------*-ooo--g--ooo-*-----*-*------%--%-%--%---%-%--%---%*-*%-*-%---r------%*-%-%------*----%-----%-%*--@--%----%--------%-*-!!!--*--%-
-------%--*-%-%-%--%-*---*%----%-%-*---%-*-*-*%-%-%--%-%-*%-%-%-%--%-%-%*-*%-*-%---%------%*-%-%--%-%-*----%--%*-%!%*-*-*-%----%LL%-----%-*------*-*%-
M------%--*-%-%-%--%-*---*%-%--%-%-*-%-%-*%*-*%y%-%-y%-%-*%-%-%-%--%-%-%*-*%-*-%-%-%-%-%--%*-%-%--%-%-*%-%-%--%*-%-%*-*-*-%-%--%--%-%---%-*--%-%-*-*%-
XXXXXXXX-XXXXXXXX-XXXX-X-XXXXX-X-XXXXXXX-XXXXXX-XXX-XXXXXXXXX-X-XX-XXXXXXXXXXXXXXXXXXXXXX-XX-XXX-XXXXXXX-XXX-XXXXXXXXXXXXXX-X-XXX-XXXX-XXXXX-X-X-XXXXX
XXXXXXXX-XXXXXXXX-XXXX-X-XXXXX-X-XXXXXXX-XXXXXX-XXX-XXXXXXXXX-X-XX-XXXXXXXXXXXXXXXXXXXXXX-XX-XXX-XXXXXXX-XXX-XXXXXXXXXXXXXX-X-XXX-XXXX-XXXXX-X-X-XXXXX
