------------------------------------------------------------------------------------------------------------------------------------------------------
------------------------------------------------------------------------------------------------------------------------------------------------------
------------------------------------------------------------------------------------------------------------------------------------------------------
------------------------------------------------------------------------------------------------------------------------------------------------------
------------------------------------------------------------------------------------------------------------------------------------------------------
------------------------------------------------------------------------------------@@@@@-------------------------------------------------------------
------------------------------------------------------------------------------------------------------------------------------------------------------
-----------------------------------------------------------------------------------------------------LLLL---------------------------------------------
---------------------------CCCoooo-@@@@@--------!!CCC-------------------------------------------------------------------------------------------------
----------------@@@@----------oooo-----------------------------------------------y------------------------------------------------ooooo---------LLLL--
-------r--r---SS-------------------------g-----------------------tt--------------*------------tt------------%%-----k----------o---ooooo---------------
--------tt----------ooo-----------o-----%%%--g------------oo--g--tt---------k----*tttt--*-----tttt----------%%----*-----------o-g-----%%------%%%%----
--k-----tttt--------ooo--------%%-o-----%%%%%-------------tt*%%%%tttt------TT----*tttt--*-----tttt----------%%----*-------UU-----%%%%*%%----*-%%%%----
M-------ttttoo-----------r-----%%-------%%%%%----------g--tt*%%%%tttt------TT%%%%*tttt--*--g--tttt------%%%%%%%---*%%---r---oo---%%%%*%%----*%%%%%----
XXXXXXXXXXXXXXXXXXXXXXXXXXXX---XX--XXXXXXXXXX-----XXXXXXXXXXXXXXXXXXX------XXXXXXXXXXX--X-----XXXXXXXXXXXXXXXXXXXXXXX---XXXXXXXXXXXXXXXX----XXXXXX----
XXXXXXXXXXXXXXXXXXXXXXXXXXXX---XX--XXXXXXXXXX-----XXXXXXXXXXXXXXXXXXX------XXXXXXXXXXX--X-----XXXXXXXXXXXXXXXXXXXXXXX---XXXXXXXXXXXXXXXX----XXXXXX----
