------------------------------------------------------------------------------------------------------------------------------------------------------
------------------------------------------------------------------------------------------------------------------------------------------------------
------------------------------------------------------------------------------------------------------------------------------------------------------
------------------------------------------------------------------------------------------------------------------------------------------------------
---------------CCC------------------LLLLL-------------------------------------------------------------------------------------------------------------
------------@@-----------------@@@@@----------------------------------------------------------------------------o-------------------------------------
----------------------------------------------LL----------------------------------------------------------------o----@@@@@----------------------------
----------------------------------------------------------------------------------------------------------------o-------------------------------------
----@@@@-----------------------------------------------------------------------------------------------ooooo--------------------------LLLL------------
-----------------------------------------!!!!!----k------!!CC---oo-----!!!--------------------ooo------oooooo-y--LLLL---------------g-----o-----------
----------r--%%%------------------%%%%------------*---k---------oo-----------SSSS--%*--oooo----%%tt----oooooott-----------*--------**-----oS----------
--------tt*tt%%%------------------%%%%*TT*----*---*-----tttt----oo--k--------------%*ttooooo---%%tt---------ott%%%%%%----%*%%%tt---**-----------------
-r-o----tt*tt%%%------------------%%%%*TT*----*---*tt---tttt---------%%%%----------%*tt--------%%tt----------tt%%%%%%%-tt%*%%%tt---**%%%------g-------
M--o----tt*tt%%%------------------%%%%*TT*----*---*tt---tttt--y------%%%%--k-------%*tt--------%%tt----------tt%%%%%%%-tt%*%%%tt%%%**%%%-------%%-----
XXXXXXXXXXXXXXXXXXXXXXXXX---------XXXXXXXX----X---XXX---XXXXXXX------XXXX----XXXXXXXXXXXXXXXXXXXXXXXXXXXXXXXXXXXXXXXXX-XXXXXXXXXXXXXXXXXXXXXXXXXXXXXXX
XXXXXXXXXXXXXXXXXXXXXXXXX---------XXXXXXXX----X---XXX---XXXXXXX------XXXX----XXXXXXXXXXXXXXXXXXXXXXXXXXXXXXXXXXXXXXXXX-XXXXXXXXXXXXXXXXXXXXXXXXXXXXXXX
