------------------------------------------------------------------------------------------------------------------------------------------------------
------------------------------------------------------------------------------------------------------------------------------------------------------
------------------------------------------------------------------------------------------------------------------------------------------------------
------------------------------------------------------------------------------------------------------------------------------------------------------
-----@@@@---------------------------------------------------------------------------------------------------------------------------------------------
------------------------------------------------------------------------------------------------------------------------------------------------------
------------------------------------------------------------------------------------------------------------------------------------------------------
SSSSS--------------------------------------oo--------------------------------------------------------------------LLLLL----------------oo--------------
------------------------------------LLLLLoo--U-----------------------------------------------------------------------------------------o------------oo
-----------y---------ooooU---------------oo---------------------------------y--------------------------r-------------------------------oooo---------oo
----tt--%%%----------oooo-%-------------%oo----g--k------------------------%%%--*----------k--tt------*------oooo-----------------------ooo!------!!oo
----tt--%%%-----------%---%--k----------%tt*---%%%----------------y----%%%%%%%--*---*%%%----*-tt*-----*------oooo-----ooooo-----------%%%tt----%%-----
----tt--%%%-----------%---%--%%%%-------%tt*%%%%%%tt-------------%%%---%%%%%%%tt*---*%%%*---**tt*----**------%TT*%%%%-----------------%%%tt----%%-----
M---tt--%%%---r-----%%%%%%%--%%%%-------%tt*%%%%%%tt--g--------r-%%%---%%%%%%%tt*-%%*%%%*---**tt*%%%%**------%TT*%%%%-------y---y---r-%%%tt----%%-----
XXXXXX--XXXXXXXXXXXXXXXXXXX--XXXXXXXXXXXXXXXXXXXXXXXXXXXXXXXXXXXXXXX---XXXXXXXXXX-XXXXXXX---XXXXXXXXXXX------XXXXXXXX------XXXXXXX----XXXXX----XXXXXXX
XXXXXX--XXXXXXXXXXXXXXXXXXX--XXXXXXXXXXXXXXXXXXXXXXXXXXXXXXXXXXXXXXX---XXXXXXXXXX-XXXXXXX---XXXXXXXXXXX------XXXXXXXX------XXXXXXX----XXXXX----XXXXXXX
