------------------------------------------------------------------------------------------------------------------------------------------------------
------------------------------------------------------------------------------------------------------------------------------------------------------
------------------------------------------------------------------------------------------------------------------------------------------------------
------------------------------------------------------------------------------------------------------------------------------------------------------
------------------------------------------------------------------------------------------------------------------------------------------------------
--------------------------------------------------------------------------------------------@@@@------------------------------------------------------
-----------------------------------------------------------------------------------------------------------------------------------------ooo----------
-----------------------------------------------------------------------------------------------------------------------------------------ooo----------
LL----------------------------------------o--------------------------------------C------------------------------ooooo--------------------ooo----------
---------------------g---------@----------o-k--r------@@@@----------oo--k---------------------------------------oooooCC---------------!!!-------------
----!---------------tt-------------------ott-%%%------------g--ooooo-----tt---k-------------*--------*-----ooooo----*--*------------------------------
-------k------------tt**----tttt-*-------ott-%%%-------------%%%%%%%%%---tt-----tt----------*--------*-----ooooo*%%%*tt*-------ttTT----tt-----y-------
-------*------------tt**%%%%tttt**-------ott-%%%-------------%%%%%%%%%---tt%%%%%tt-----@@@@@*--------*---------**%%%*tt*tt-----ttTT----tttt**---------
M------*---------k--tt**%%%%tttt**--------tt%%%%-ooooo-------%%%%%%%%%---tt%%%%%tt--g-------*--------*------%%%**%%%*tt*tt-----ttTT----tttt**----ooooo
XXXXXXXXXXXX--XXXXXXXXXXXXXXXXXXXXXXXXXXXXXXXXXXXXXXXXXXXXX--XXXXXXXXXXXXXXXXXXXXXXXXXXXX---XXXXXXXXXXXXXXXXXXXXXXXXXXXXXXXXXXXXXXX----XXXXXX------XXX
XXXXXXXXXXXX--XXXXXXXXXXXXXXXXXXXXXXXXXXXXXXXXXXXXXXXXXXXXX--XXXXXXXXXXXXXXXXXXXXXXXXXXXX---XXXXXXXXXXXXXXXXXXXXXXXXXXXXXXXXXXXXXXX----XXXXXX------XXX
