------------------------------------------------------------------------------------------------------------------------------------------------------
------------------------------------------------------------------------------------------------------------------------------------------------------
------------------------------------------------------------------------------------------------------------------------------------------------------
------------------------------------------------------------------------------------------------------------------------------------------------------
------------------------------------------------------------------------------------------------------------------------------------------------------
------------------------------------------------------------------------------------------------------------------------------------------------------
---------------------L----!!-----------------------------------------------------------------------------------------------------------------------L--
-------------------------------------@@---ooooo---------------------------------------UUUU----------@@@@-----------SSS--------------------------------
ooooo-------------------------------------------------!!----------------------------------------------------------------------------------------------
ooooo-y-----------------------y-----o---r-----------------k---------------------------------y--ooooo--------------------------------------------------
ooooo-%%%%-*-------*---%---tt-tt----%%%%%%%------------*%----k-ooo*-*---------%%-------------*--------tt-----------*------------k--------------------S
----%-%%%%**tt-----*---%-**tt*tt----%%%%%%%-*--oooo----*%---%%%ooo*-*---------%%----------tt-*----%%%%tt-----------*-------------**tt*--------------o-
----%-%%%%**tt----C*%%%%***tt*tt----%%%%%%%-*%%------o-*%---%%%---***-------tt%%-------%%%tt**--tt%%%%tt-----------*-------------**tt*-------------*o-
M---%-%%%%**tt-----*%%%%***tt*tt--r-%%%%%%%%*%%--------*%---%%%---***----%%%tt%%-------%%%tt**--tt%%%%tt-----------*-------------**tt*-----------y-*o-
XXXXX-XXXXXXXXXXXXXXXXXXXXXXXXXX----XXXXXXXXXXXXXXXXXXXXX---XXXXXXXXXXXXXXXXXXXXXXX----XXXXXXX--XXXXXXXX-----------XXXXXXXXXXX---XXXXXXXXXXX---XXXXX--
XXXXX-XXXXXXXXXXXXXXXXXXXXXXXXXX----XXXXXXXXXXXXXXXXXXXXX---XXXXXXXXXXXXXXXXXXXXXXX----XXXXXXX--XXXXXXXX-----------XXXXXXXXXXX---XXXXXXXXXXX---XXXXX--
