------------------------------------------------------------------------------------------------------------------------------------------------------
------------------------------------------------------------------------------------------------------------------------------------------------------
------------------------------------------------------------------------------------------------------------------------------------------------------
------------------------------------------------------------------------------------------------------------------------------------------------------
------------------------------------------------------------------------------------------------------------------------------------------------------
------------------------------------------------------------------------------------------------------------------------------------------------------
----------------LLLLL-------------------------------------------------------------------------------------------------o-------------------------------
SSSSS-----------------------------------------------------------------------------------------oo----------------------o-------------------------------
-----------------------------------------------------------------------------------------------------------------oooooo-------------------------------
-------------------------------------------y-------CC----------!---------------------------------r---------------ooooo---y----------ooooo-------------
-----o-----------------------------%%-------*--------------------CC--------ttoo----------------*%%%-----*---------*------tt---------oooooooo----------
-----oooooo----------*-------------%%-------*------------tt----------------tt*------*-------k--*%%%--LL-*%**------*--*---tt-----------tttt--o---------
-----oooo--ooooo----**-------------%%-------*----r-------tt----------------tt*------*--------tt*%%%-----*%**----tt*tt*tt-tt----UUUUU--tttt------------
M-------------oo----**----------y--%%-------*%%%---------tt-----o----k-----tt*---g--*--------tt*%%%oo---*%**----tt*tt*tt-tt--r--------tttt------------
XXXXXXXXXXXXXXXXXXXXXXXXXXXXXX-----XXXXX----XXXX----XXXXXXXXXXXXXXXXXXXXXXXXXXXXXXXXXXXXXXXXXXXXXXXXXXXXXXXX----XXXXXXXX-XXXXX---XXXXXXXXXXXXXXXXXXXXX
XXXXXXXXXXXXXXXXXXXXXXXXXXXXXX-----XXXXX----XXXX----XXXXXXXXXXXXXXXXXXXXXXXXXXXXXXXXXXXXXXXXXXXXXXXXXXXXXXXX----XXXXXXXX-XXXXX---XXXXXXXXXXXXXXXXXXXXX
