------------------------------------------------------------------------------------------------------------------------------------------------------
------------------------------------------------------------------------------------------------------------------------------------------------------
------------------------------------------------------------------------------------------------------------------------------------------------------
------------------------------------------------------------------------------------------------------------------------------------------------------
------------------------------------------------------------------------------------------------------------------------------------------------------
-----------------------------------------------------------@@@@---------------------------------------------------------------------------------------
----------SSSSS---------------------------------------------------------------------------------------------------------@@@---------------------------
--------------------!!----ooooo--------------------------------oo-------------------------------------------------------------------------------------
---------------------------------------------------------------oo-------------------------------------------------------------------------------------
-------------------------------SSSSooo-------------------------oo-------------------------------------------y-------------------oooo-----------!!!!!--
-----------------y-----------------ooo------------------tt-------UUUUU----*---------------ooooo----------r--*--------%%%%----g--oooo-----tt--k--------
-------**-----%%%%%%%-oooo%%%%------------ooooo---------tttt--------------*-------------k--------------otttt*--------%%%%tt-tt--oooo-----tttt---------
oo-----***----%%%%%%%-----%%%%*-----*---g-ooooo-------**tttt---*------tt--*-----------*-----------------tttt*%%%----*%%%%tt*tt*%%%%-tt---tttt---------
M---k--***--%%%%%%%%%-----%%%%*-%%%%*%%---ooooo-------**tttt---*------tt--*--r---r----*----------y---y--tttt*%%%----*%%%%tt*tt*%%%%-tt---tttt---------
XXXX---XXX--XXXXXXXXXXXXXXXXXXX-XXXXXXX----XXXXXXXXXXXXXXXXX---XXXX---XX--X----XXXXXXXX---XXXXXXXXXXXXXXXXXXXXXX----XXXXXXXXXXXXXXX-XX---XXXX----XXXXX
XXXX---XXX--XXXXXXXXXXXXXXXXXXX-XXXXXXX----XXXXXXXXXXXXXXXXX---XXXX---XX--X----XXXXXXXX---XXXXXXXXXXXXXXXXXXXXXX----XXXXXXXXXXXXXXX-XX---XXXX----XXXXX
