------------------------------------------------------------------------------------------------------------------------------------------------------
------------------------------------------------------------------------------------------------------------------------------------------------------
------------------------------------------------------------------------------------------------------------------------------------------------------
------------------------------------------------------------------------------------------------------------------------------------------------------
------------------------------------------------------------------------------------------------------------------------------------------------------
------------------------------------------------------------------------------------------------------------------------------------------------------
-----------------------------------SS-----------------------------------ooo---------------------------------------------------------------------------
----oo------------------------------------------------------------------ooooo------------UUUUU--------------------------------------------------------
----oo--------------------------ooo------------------------------------o---oo-----------------UUUUU-----------------------------------!!--------------
--------------------------------ooo------------------------------------o---oo------------------------------------ooooo-------------g------------------
-----tt--------------tt---------ooo------------------------------------o--*-----------g----------------*---------------y-------%%%--------*-----------
-----tt------------tttt%%%%--ooo---%%%%---------oo------------ooooooooo---**--*-----%%tt-----------o---*---o--------tt*--------%%%%%%*----*---tt----@@
--k-*tt----------%%tttt%%%%--------%%%%---------oo------------------------**--*-----%%tt---*----%%*o--%*---oSoooo---tt*--------%%%%%%*----*---tt------
M---*tt----------%%tttt%%%%--------%%%%------------g---g------------------**--*-----%%tt---*%%%%%%*---%*---o-oooo---tt*----%%%%%%%%%%*----*---tt--r---
XXX-XXXXXXXXX----XXXXXXXXXXXXXXXXXXXXXX------XXXXXXXXX---XXXXXXXX---XXXXXXXX--XXXXXXXXXX---XXXXXXXX---XX-----XXXXXXXXXXXXXXXXXXXXXXXXX----X---XXXXXX--
XXX-XXXXXXXXX----XXXXXXXXXXXXXXXXXXXXXX------XXXXXXXXX---XXXXXXXX---XXXXXXXX--XXXXXXXXXX---XXXXXXXX---XX-----XXXXXXXXXXXXXXXXXXXXXXXXX----X---XXXXXX--
