------------------------------------------------------------------------------------------------------------------------------------------------------
------------------------------------------------------------------------------------------------------------------------------------------------------
------------------------------------------------------------------------------------------------------------------------------------------------------
------------------------------------------------------------------------------------------------------------------------------------------------------
---------------------------------------------------------------------------------------------ooLLLL---------------------------------------------------
---------------------------------------------------------------------------------------------oo---------------------------------------------------CCCC
------o--------------------------------------------------------------------------------------oo-------------------------------------------------------
------o------------------------------------------------------------------------------------------------------------------oo---------------------------
-----Lo----------------------------------------------------------------o--------UUUUU-------o------------------------oooooo---------------------------
-----------------------------------------------------------------------o-g--LL--------g---g-o------------ooo---oo--y-------ooooo-------------CC-------
------------tt----CCCC-----*-----------------*--------------y-------%--ott---------**--%%-tt%%-%-------*-ooo--o-----*------ooooo---------*------------
----o------*tt--r---------**------------%%%%%*------**-----tt-ooooo-%%--tt-------tt**%%%%-tt%%*%-------*----ooo-----*---tt------U-------**UUU--------t
--r--%%%%--*tt*-----------**----*-------%%%%%*----*-**-----tt-ooooo-%%tttt%%%----tt**%%%%*tt%%*%-------*----ooo-tt--*%tttt--------------**-----------t
M----%%%%--*tt*-----------**----*-------%%%%%*%%--*-**-----tt-ooooo-%%tttt%%%----tt**%%%%*tt%%*%-------*--------tt--*%tttt--------k-----**------g----t
XXXXXXXXX--XXXX---XXXXXXXXXX----XXXXXXXXXXXXXXXX--X-XX-----XXXXXXXXXXXXXXXXXX----XXXXXXXXXXXXXXXXXXXXXXXXXXXXXXXXX--XXXXXXXXXXXXXX--XXXXXXXXXXXXXXXXXX
XXXXXXXXX--XXXX---XXXXXXXXXX----XXXXXXXXXXXXXXXX--X-XX-----XXXXXXXXXXXXXXXXXX----XXXXXXXXXXXXXXXXXXXXXXXXXXXXXXXXX--XXXXXXXXXXXXXX--XXXXXXXXXXXXXXXXXX
