------------------------------------------------------------------------------------------------------------------------------------------------------
------------------------------------------------------------------------------------------------------------------------------------------------------
------------------------------------------------------------------------------------------------------------------------------------------------------
------------------------------------------------------------------------------------------------------------------------------------------------------
------------------------ooo---------------SSS---------------------------------------------------------------------------------------------------------
------------------------ooo-----------------------------------------------------------------------ooo-------------------------------------------------
------------------------ooo-------oo--------------------------------------------------------------ooo-------------------------------------------------
----------------------------------oo--------------------------------------------------------------ooo-----------------------ooo-----------CCCC--------
----------------------------------oo---------------------------------------------------------ooooo--------------------------ooo-----------------------
@@@@------SUUUUU@@@@@------------------------o--------------------------o------------------k----------------------------oooo--------------------------
-------------------------tt!!!!CC--------%%%-oCCC-----%-------oo--------o--r--------tt----**%%---%%%%--o------------y---oooo------------r---%%--------
-------------------------tt----------%%%%%%%----------%-----------------o-*--o------tt----**%%---%%%%----*--------tt------tt-------------*tt%%*-------
-------------------------tt--------tt%%%%%%%----------%----tt---**TT---**%*-------tttt*---**%%---%%%%oo--*--------tt%%-S-*tt%----------tt*tt%%*-------
M--%-y--k----------------tt--------tt%%%%%%%-------k--%----tt---**TT---**%*-------tttt*---**%%---%%%%----*--------tt%%---*tt%----------tt*tt%%*-------
XXXXXXXXXXXXXXXXXXXXXXXXXXXXXXX----XXXXXXXXX----------XXXXXXXXXXXXXXXXXXXXXXXXXXXXXXXXX---XXXX---XXXX----XXXXXXXXXXXXX---XXXXXXXXXXXXXXXXXXXXXXXXXXXX-
XXXXXXXXXXXXXXXXXXXXXXXXXXXXXXX----XXXXXXXXX----------XXXXXXXXXXXXXXXXXXXXXXXXXXXXXXXXX---XXXX---XXXX----XXXXXXXXXXXXX---XXXXXXXXXXXXXXXXXXXXXXXXXXXX-
