------------------------------------------------------------------------------------------------------------------------------------------------------
------------------------------------------------------------------------------------------------------------------------------------------------------
------------------------------------------------------------------------------------------------------------------------------------------------------
------------------------------------------------------------------------------------------------------------------------------------------------------
----------------------------------------------------------------------------------------------------------ooo-----------------------------------------
----------------------------------------------------------------------------------------------------------ooo---ooooo---------------------------------
----------------------------------------------------------------------------------------------------------ooo---ooooo---------------------------------
----------ooooo-------------------------------------------------------------------------------------------------ooooo----o----------------------------
CCCCCLLLLLooooo------------SSSS------------------------------------------------------------------------ooo---------------o----------------------------
----------ooooo---------------------g-------------------------------------------------------------------------k------SS-------------------------------
---------------------g-----------k-%%%-----k-@@--r-%%--------------ooo---------r----------o----------------%%%%--------oo---*%%%%--------------%%%%---
----------------------%---------%%%%%%---tt*-----tt%%--------------ooo----ooo--tt-----CCCCo--------------tt%%%%-*-------*---*%%%%--k-----------%%%%---
----------tt----------%---------%%%%%%---tt**%%%%tt%%--------------ooo----ooo--tt---------o--r--------tt-tt%%%%-*%*-----**--*%%%%**-------%%---%%%%---
M---------tt-----y----%---------%%%%%%-r-tt**%%%%tt%%-------------------k------tt--g---------%%%%-----tt-tt%%%%-*%*%%%%-**--*%%%%**-------%%---%%%%---
XXXXXX----XXXXXXXXXXXXXXXXXX----XXXXXX---XXXXXXXXXXXXXXXXXXXXXXX----XXXXXXXXXXXXX------------XXXX-----XX-XXXXXX-XXXXXXX-XX--XXXXXXXXXXXXXXXX---XXXXXXX
XXXXXX----XXXXXXXXXXXXXXXXXX----XXXXXX---XXXXXXXXXXXXXXXXXXXXXXX----XXXXXXXXXXXXX------------XXXX-----XX-XXXXXX-XXXXXXX-XX--XXXXXXXXXXXXXXXX---XXXXXXX
