------------------------------------------------------------------------------------------------------------------------------------------------------
------------------------------------------------------------------------------------------------------------------------------------------------------
------------------------------------------------------------------------------------------------------------------------------------------------------
------------------------------------------------------------------------------------------------------------------------------------------------------
------------------------------------------------------------------------------------------------------------------------------------------------------
------------------------------------------------------------------------------------------------------------------------------------------------------
------------------------------------------------------------------------------------------------------------------------------------------------------
-------------------oo-----------@@-----UUUUUooooo-----------------------------------------------------------------------------------------------------
----------SSSS-----oo------SSSSS------------ooooo----------------------------oo-------------------------------------LLLL------------------------------
oo------------!!!!!oo--------------------------------------------------------oo-----------------------------------------------------------------------
oo-----------------------------tt-------------------tt-----------oo-------*--oo--r----g--------------%------------------------------------------------
oo-----------------------------tt------%%--------*--tt------*----TT-------*-----*--%%%%------tttttttt%------------k--------*--------------------------
--------*--------%%%%------%%tttt------%%---%%%tt*%%tttt----*----TT-------*----**tt%%%%tt%%%%tttttttt%-----------tt--------*-------LL------------*ooo-
M--k----*--------%%%%-y--r-%%tttt%%%---%%--%%%%tt*%%tttt----*----TT--r----*----**tt%%%%tt%%%%tttttttt%-----r--k--tt--------*%----g---------------*ooo-
XXXXXXXXXXXXXXXXXXXXXXXXXXXXXXXXXXXX---XX--XXXXXXXXXXXXX----X----XXXXXXXXXX----XXXXXXXXXXXXXXXXXXXXXXXXXXXXXX----XX---XXXXXXXXXXXXXXXXXXXXXXX----X----
XXXXXXXXXXXXXXXXXXXXXXXXXXXXXXXXXXXX---XX--XXXXXXXXXXXXX----X----XXXXXXXXXX----XXXXXXXXXXXXXXXXXXXXXXXXXXXXXX----XX---XXXXXXXXXXXXXXXXXXXXXXX----X----
