------------------------------------------------------------------------------------------------------------------------------------------------------
------------------------------------------------------------------------------------------------------------------------------------------------------
------------------------------------------------------------------------------------------------------------------------------------------------------
------------------------------------------------------------------------------------------------------------------------------------------------------
------------------------------------------------------------------------------------------------------------------------------------------------------
---------------------------------------------------------------------@@@@-------------------------------------------------ooo-------------------------
--------------------------------LLL-------------------------------------------------------o-------------------------------ooo-------------------------
-----------------------------------UUUU----------------------------------------------UUUUU------------------------------------------------------------
--------------o------------------------------------------------------------LLLL-----------------------------------------------------------------------
ooo-----------o--------------------------------------------------------------------------------------------------o----o--------y----------------------
ooo-----L-----o----------------------------TT---g------------------------tt-------------%%tt--tt-----------tt----o----o---**-*----------k-%---%%%%---!
ooo-------------------------------%%%------TTtt-------*tt--------------tttt---*--------*%%tt*-tt*%%%%----tttt--k-------ooo**-*-----------*%---%%%%----
---------------oooo---UUU-----k---%%%------TTtt-------*tt------------tttttt*tt*--------*%%tt**tt*%%%%-UU*tttttt*tt-%------****--*---tt---*%-*-%%%%----
M----r----k----oooo--------r--%%%%%%%------TTtt%%---g-*tt------------tttttt*tt*--------*%%tt**tt*%%%%---*tttttt*tt-%------****--*---tt---*%%*-%%%%----
XXXXXXXXXXXXXXXXXX------XXXXXXXXXXXXXXXXXXXXXXXXXXXXXXXXXXXX---------XXXXXXXXXXXXXXXXXXXXXXXXXXXXXXXX---XXXXXXXXXX-XXXXXXXXXXX--X---XXXXXXXXX-XXXXXXXX
XXXXXXXXXXXXXXXXXX------XXXXXXXXXXXXXXXXXXXXXXXXXXXXXXXXXXXX---------XXXXXXXXXXXXXXXXXXXXXXXXXXXXXXXX---XXXXXXXXXX-XXXXXXXXXXX--X---XXXXXXXXX-XXXXXXXX
