------------------------------------------------------------------------------------------------------------------------------------------------------
------------------------------------------------------------------------------------------------------------------------------------------------------
------------------------------------------------------------------------------------------------------------------------------------------------------
------------------------------------------------------------------------------------------------------------------------------------------------------
------------------------------------------------------------------------------LLLLL-------------------------------------S-----------------------------
---------------------------------------------------------------LLLLL------------------------------------!!!!------------------------------------------
------------------------------------------------------------------------------------------------------------------------------------------------------
-----------------------------------------------------------------------------------ooooo-----------@@@@---------@@@@---------------------ooooo--------
-----UUUUU----------------------UU-------------------ooooo---------------------------------------------C---------------------------------ooooo--------
ooSSS-----------k------------ooo--------------------------------------------------------@@--r----r-------------------------y------oo------------------
oo-----%%%C----*-------------ooo-*---------ooooo-----------------------------*TTtt-----------*tt----------------------g-TTtt------oo--k----*----------
oo-----%%%-ooo-*----%%%----------*tttt---*tt%%%---------%%--g---tt----------%*TTtt%*---------*tttt----tt%%-*-------tt---TTtt---k--oo----*tt*----------
-------%%%-ooo-*%%%*%%%----------*tttt---*tt%%%--------*%%--*---tt---%%*----%*TTtt%*-----%%%%*tttt----tt%%-*-------tt---TTttTT%%%%------*tt*--o-------
M------%%%-ooo-*%%%*%%%----------*tttt---*tt%%%--------*%%--*%%%tt---%%*----%*TTtt%*-----%%%%*tttt%%%%tt%%%*--k----tt---TTttTT%%%%------*tt*-----r----
XXXXXXXXXXXXXXXXXXXXXXX-----XXXXXXXXXX---XXXXXXXXXXXXXXXXX--XXXXXX---XXX----XXXXXXXXXXXXXXXXXXXXXXXXXXXXXXXX-------XX---XXXXXXXXXX------XXXXXXXXXXXXXX
XXXXXXXXXXXXXXXXXXXXXXX-----XXXXXXXXXX---XXXXXXXXXXXXXXXXX--XXXXXX---XXX----XXXXXXXXXXXXXXXXXXXXXXXXXXXXXXXX-------XX---XXXXXXXXXX------XXXXXXXXXXXXXX
