------------------------------------------------------------------------------------------------------------------------------------------------------
------------------------------------------------------------------------------------------------------------------------------------------------------
------------------------------------------------------------------------------------------------------------------------------------------------------
------------------------------------------------------------------------------------------------------------------------------------------------------
-----------------------------------------------------------------------------------------------------------------------------------------------!!!!---
------------------------------------------------------------------------------------------------------------------------------------------------------
----------SSSSS---------------------------------------------------------------------------------------------------------------------------------------
----------------------------------------------------o-------------------------------------------------------------------------------------------------
--------------------------------------------------------------------------------------------------------------------------------!!!!---------------CCC
---------------------------------------------------------------------------------------------r--------------------g-----------------------------------
-----------%%%---r----g---------*------ooooo------y------tt---------*----------------tt------tt*%%%%---oooo-----tt---L------tt------!!!!!--*---tt-----
-------y---%%%----%%%%----------*------ooooo-------%%----tt--------o**--%%%%---------tt------tt*%%%%*-----------tt-------*--tt-------------*---tt-----
--r------tt%%%TTtt%%%%%%%-------*------------------%%----tt--------o**TT%%%%-SS------tt----%%tt*%%%%*--------*--tt-------*%%tttt%%tt-------*-%%tt----%
M----%%%%tt%%%TTtt%%%%%%%-------*-------------g----%%----tt--------o**TT%%%%---------tt----%%tt*%%%%*--------*--tt-------*%%tttt%%tt-------*-%%tt----%
XXXXXXXXXXXXXXXXXXXXXXXXXXXXXXX-X---------XXXXXXXXXXX----XX----XXXXXXXXXXXXX----XXXXXXX----XXXXXXXXXXXXXXXXXXX--XX-------XXXXXXXXXXX--XXXXXX-XXXX----X
XXXXXXXXXXXXXXXXXXXXXXXXXXXXXXX-X---------XXXXXXXXXXX----XX----XXXXXXXXXXXXX----XXXXXXX----XXXXXXXXXXXXXXXXXXX--XX-------XXXXXXXXXXX--XXXXXX-XXXX----X
