------------------------------------------------------------------------------------------------------------------------------------------------------
------------------------------------------------------------------------------------------------------------------------------------------------------
------------------------------------------------------------------------------------------------------------------------------------------------------
------------------------------------------------------------------------------------------------------------------------------------------------------
------------------------------------------------------------------------------------------------------------------------------------------------------
------------------------------------------------------------------------------------------------------------------------------------------------------
-------------------------------------------------------------------------------------------------------------------------------------------SSSSS------
----------------------o------------------------------------------ooooo--------------------------------------------------------------------------------
-------------oo-------o------------------------------------------ooooo--------------------------------------------oo----------------------------------
-------------oo---o----------------------------------------------------oooo---ooooo-------------------------------oo----------------------------------
------oooo----%%--o----tt--SSS-----------------*-------------------------%----ooooo----tt-----o-------------------oo---------------------y------------
oo------------%%-o-UUU*tt-------------S-------**tt-----------------------%--k----tt----tt---LLo-g-------------------------------------%%%%------------
oo--------U---%%------*tt-----------*S-------***tt-!-------------tt----%%%*%%%%tttt----tt%%---o-tt-------------------------oo---------%%%%%%----UUUUtt
M---g---------%%------*tt-----------*----y---***tt---g---------y-tt%%%%%%%*%%%%tttt----tt%%-----tt-y-o----g----------------oo--r------%%%%%%--------tt
XXXXXXXX------XXXXX---XXXXXXXXXXXX--XXXXXXXXXXXXXXXXXXXXXXXXXXXXXXXXXXXXXXXXXXXXXXX----XXXX-----XXXXXXXXXXXXXXXXXXXXXXXXXXX---XXXXXX--XXXXXXXXXXXXXXXX
XXXXXXXX------XXXXX---XXXXXXXXXXXX--XXXXXXXXXXXXXXXXXXXXXXXXXXXXXXXXXXXXXXXXXXXXXXX----XXXX-----XXXXXXXXXXXXXXXXXXXXXXXXXXX---XXXXXX--XXXXXXXXXXXXXXXX
