------------------------------------------------------------------------------------------------------------------------------------------------------
------------------------------------------------------------------------------------------------------------------------------------------------------
------------------------------------------------------------------------------------------------------------------------------------------------------
------------------------------------------------------------------------------------------------------------------------------------------------------
-----------------------------------------------------------------------------------------------------SSSSS--------------------------------------------
------------------------------------------------------------------------------------------------------------------------------------------------------
----------------oooo--------------------------------------------------------------------------------------------------------------------LLLL----------
---------------------------------------------------------------------------LLL-----ooooo------------------------CCCC-o-----SSSSSoooo------------------
---------LLLL----------------------------------------------------------------------ooooo-----------------------------o--------------------------------
-------g---------------k------------------y----------------g--------g------------------------o--y------------k------------------------k---------------
ooooo*--------r----*----%--*----g-----%--*-----%--r----------*------%UU---------g---%-----g--o---*%--*------*%----*-----r------*-%-*%---%--%----------
-%*%-*---*%---*--%-*---*%--*%-%---%---%-%*-*-%-%--*-----%--%-*--%-%-%--------*--%---%*---%----*--*%o-*------*%-%--*------%----%*-%-*%-%-%--%-----k----
-%*%-*-%-*%-%-*-*%-*---*%--*%-%-%-%---%-%*-*-%-%--*-*o%-%--%-*--%-%-%-%--r---*--%---%*-%-%--%-*--*%--*-----%*%-%-%*-g*-%-%----%*-%-*%-%-%--%------*---
M%*%-*-%-*%-%-*-*%-*--%*%-%*%-%-%-%---%-%*-*-%-%--*-*o%-%--%-*--%-%-%-%-%-%-%*--%---%*-%-%--%-*--*%-k*---%-%*%-%-%*-%*-%-%--%-%*-%-*%-%-%--%-----%*%--
XXXXXXXXXXXXXXXXXX-XX-XXXXXXXXXXXXX-X-X-XXXXXXXX-XXXX-XXX-XXXXX-XXXXXXX-XXXXXXX-XX-XXXXX-XX-XXXX-XXX-X-X-XXXXXXXXXXXXXXXXX-XXXXXXXXXX-XXXX-XX-X-XXXXX-
XXXXXXXXXXXXXXXXXX-XX-XXXXXXXXXXXXX-X-X-XXXXXXXX-XXXX-XXX-XXXXX-XXXXXXX-XXXXXXX-XX-XXXXX-XX-XXXX-XXX-X-X-XXXXXXXXXXXXXXXXX-XXXXXXXXXX-XXXX-XX-X-XXXXX-
