------------------------------------------------------------------------------------------------------------------------------------------------------
------------------------------------------------------------------------------------------------------------------------------------------------------
------------------------------------------------------------------------------------------------------------------------------------------------------
------------------------------------------------------------------------------------------------------------------------------------------------------
------------------------------------------------------------------------------------------------------------------------------------------------------
------------------------------------------------ooo----------------------------------oo---------------------------------------------------------------
------------------------------------------------ooo----------------------------------oo------------------------------------------------------------oo-
------------------------------------!!!---------ooo----------------------------------oo------------------------------------------------------------oo-
------------------------------------------------------------------------------------o---oo---------@@-------------------------------------------------
--------oo---------------------------------------------oo---------------------------o--!oo------------------------------------------------------------
--------oo-tt------------------------TT---------*--oo--oo-*-------------------------o-*-ooo---------------oo---------------oo------------------------k
ooo-----oo-tt*-------tt-----tt-------TTo--k---g-*--oo-----*-*%%%*--------oo-%%%%------*---o---------------oo---------------oo----------ooo--------%%%%
ooo--------tt*-----tttt---tttt-------TTo----tttt*----oott****%%%*--------oo-%%%%------*-*--tt------------------------------oo--------------------%%%%%
M----------tt*-----tttt%%%tttt-------TTo----tttt*------tt****%%%*--g---y----%%%%------*-*--tt-----------------g---------------------------%%-----%%%%%
XXXXXXX----XXXXXX--XXXXXXXXXXXXXXXX--XX-----XXXXXXXXXXXXXXXXXXXXXXXXXXXX----XXXX-XXX--X-X--XXXXXXXXXXXXXXXXXXXXXXXXXXXXXXXXXXXXXXXXXXXXXXXXXXXXX-XXXXX
XXXXXXX----XXXXXX--XXXXXXXXXXXXXXXX--XX-----XXXXXXXXXXXXXXXXXXXXXXXXXXXX----XXXX-XXX--X-X--XXXXXXXXXXXXXXXXXXXXXXXXXXXXXXXXXXXXXXXXXXXXXXXXXXXXX-XXXXX
