------------------------------------------------------------------------------------------------------------------------------------------------------
------------------------------------------------------------------------------------------------------------------------------------------------------
------------------------------------------------------------------------------------------------------------------------------------------------------
------------------------------------------------------------------------------------------------------------------------------------------------------
------------------------------------------------------------------------------UUUU--------------------------------------------------------------------
----------------------------------------------------------------------------------------------------------!-------------------------------------------
------------------------------------------------------------------------------------------------------------------------------------------------------
-----------------------------------------------------------------------------------------------------------------------------------------------ooo----
-------------------ooo------------------------------------!!!----------------------------------------------------------------------------------ooo----
----------------------------------------g----r------LLLLL------------------g------------------------------------------------------------------------r-
----y-----------------!!!---------------*---*%%----------C-----------------tt---tt----------------------r-------------------TT---*-----------y---tt---
----tt----------g---------------tt------*---*%%----*----------------------%tt-tttt-----------------------tt-----------------TT---*--------%%%%%%-tt---
----tt------------%%%--**------*tt------*---*%%----*------------tt--------%tt-tttt------------------*----ttoooo-------------TT---*--------%%%%%%%tt---
M--%tt-g---g------%%%--**--r---*tt--k---*---*%%----*------------tt--------%tt-tttt----------g-------*----ttoooo--k---k------TT---*--------%%%%%%%tt---
XXXXXX----XXXXXXXXXXX--XXXXXXXXXXXXXXXXXX---XXX----XXXXXXXXXXXXXXXXXXXXXXXXXX-XXXXXXXXXXXXXXXXXXXXXXXXXX-XXXXXXXXXXXXXXXXXXXXX---XXXXXXXXXXXXXXXXXXXXX
XXXXXX----XXXXXXXXXXX--XXXXXXXXXXXXXXXXXX---XXX----XXXXXXXXXXXXXXXXXXXXXXXXXX-XXXXXXXXXXXXXXXXXXXXXXXXXX-XXXXXXXXXXXXXXXXXXXXX---XXXXXXXXXXXXXXXXXXXXX
