------------------------------------------------------------------------------------------------------------------------------------------------------
------------------------------------------------------------------------------------------------------------------------------------------------------
------------------------------------------------------------------------------------------------------------------------------------------------------
------------------------------------------------------------------------------------------------------------------------------------------------------
------------------------------------------------------------------------@@----------------------------------------------------------------------------
-------------------------------------------------------------------o----------------------------------------------------------------------------------
-------------------------------------------------------------------o-----------LLLL-------------------------------------------------------UUUUU-------
--------------SSS--------------------------------------------------o-ooo------------------------------------------------------------------------------
-----------------------SSSS-----SSSS--------LL----------------------------------------------------------------------------CCCCo-----------------------
ooooo----y-ooo---------------------------------------------------k----------r--------------------------------------LLLL-r-----o-----------------------
ooooo---%%%ooo-*---TT----tt------------------------------------tt--%%*--tttttttt---%%%%%--k-----------------g-----------*-----o-tt--------------------
ooooo-r-%%%ooo-*---TT----tt---oo--------------------tt---------tt--%%*--tttttttt---%%%%%-*---oo--------------tt---------*-------tt--------tt----r-----
------%%%%%%%%%*---TT----tt@@@----------------!-----tt-------tttt%%%%*tttttttttt---%%%%%-*-------------------tt---------*------ott---UUUUUtt--*--tt---
M-----%%%%%%%%%*---TT----tt-------------------------tt--g----tttt%%%%*tttttttttt---%%%%%-*-------y---r---k---tt---------*------ott--------tt-%*--tt---
XXXXXXXXXXXXXXXXXXXXX----XX---XXXXXXXXXXXXXXXXXX----XXXXXXXXXXXXXXXXXXXXXXXXXXXXXXXXXXXX-XXXXXX-XXXXXXXXXXX--XXXXXXX----X--XXXXXXXXXXXXXXXXX-XX--XXXXX
XXXXXXXXXXXXXXXXXXXXX----XX---XXXXXXXXXXXXXXXXXX----XXXXXXXXXXXXXXXXXXXXXXXXXXXXXXXXXXXX-XXXXXX-XXXXXXXXXXX--XXXXXXX----X--XXXXXXXXXXXXXXXXX-XX--XXXXX
