------------------------------------------------------------------------------------------------------------------------------------------------------
------------------------------------------------------------------------------------------------------------------------------------------------------
------------------------------------------------------------------------------------------------------------------------------------------------------
------------------------------------------------------------------------------------------------------------------------------------------------------
-------------------------------------------------------------------------------------------------------------------------UUUUU------oo----------------
--------------------------------ooooo-------------ooo-------------------------------------------------------------------------------oo----------------
---------------------------oooo-oooooCCCCCCCCCC---ooo-----oo--------------------------oo--------------------------------------------oo----------------
--------------------------------ooooo-------------ooo-----oo-----oooo-----------------oo!!!----------------------------------------------------------S
--------------@@@ooooo------------------------------------oo-----oooo-----ooo---------oo--------------------ooooo--------------------------------oooo-
-------------o---ooooo---------k----------------r-----!------@@@@---------ooog--------------LLLLLLLL--------ooooo-LLLLL-----------------ooo----o------
----------oo-o---ooooo---%%%%--%%--------------%tt%%------tt-----%%%------%%%%ooo----------o----------------ooooo------oo-tt--------tt--ooo----ok----%
--------%----o-----------%%%%tt%%-------TT-----%tt%%------tt-----%%%------%%%%ooo----------o-----tt--C----%------------oo-tt--------tt-------%*-tt---%
--------%r--g------------%%%%tt%%-------TT-----%tt%%------tt---tt%%%--tt--%%%%tt----%%%%%--o-----tt%o-----%--tt-----TT-oo-tt----tt--tt%%%%---%*-tt---%
M-------%%%%%------------%%%%tt%%-------TT-----%tt%%-y----ttg--tt%%%-gtt--%%%%tt-k--%%%%%--------tt%------%--tt--g--TT----tt%%%%tt--tt%%%%-g-%*-tt---%
XXXXXXXXXXXXXXXXXXXXXXXXXXXXXXXXXXXXXXXXXXXXXXXXXXXXXXXXXXXXXXXXXXXXXXXXXXXXXXXXXXXXXXXXXXXXXXXXXXXXXXXXXXXXXXXXXXXXXXXXXXXXXXXXXXXXXXXXXX---XXXXXXXXX
XXXXXXXXXXXXXXXXXXXXXXXXXXXXXXXXXXXXXXXXXXXXXXXXXXXXXXXXXXXXXXXXXXXXXXXXXXXXXXXXXXXXXXXXXXXXXXXXXXXXXXXXXXXXXXXXXXXXXXXXXXXXXXXXXXXXXXXXXX---XXXXXXXXX
