------------------------------------------------------------------------------------------------------------------------------------------------------
------------------------------------------------------------------------------------------------------------------------------------------------------
------------------------------------------------------------------------------------------------------------------------------------------------------
------------------------------------------------------------------------------------------------------------------------------------------------------
-----------------------------------------!!!!---------------------------------------------------------------------------------------------------------
--------------------------------------------------------------------------------------------------------------------------------------SSSSS-----------
--------------------------------ooooooooo---------------------------------oo--------------------------CCCC----------------------LL--------------------
----------------------------CCC-ooooooooo----ooooo-----------------------------------------------------------------------------------o----------------
-------ooo-----------------------------------ooooo-----------ooo-------------------------!!!!-----------------oooo-------------------o----------------
-------------oo------------------------------oooook----------ooo------------------------------------@-----ooo@oooo-------------------o----------------
-------------oo--------------------------tt------TT---------------------%%%-----------ooo----------o--%---ooo---tt--------------tt-%%%%----o----------
----------y--oog-tt------yoo----------%--tt------TT---%---tt------------%%%---%%%%----ooo-%--oo----tt-%---ooo--%tt------@@@@oooott%%%%%---------------
--------%%%%---%%tt------%%%%TT-------%--tt--%%%%TT---%---tt--%%%-------%%%tt-%%%%------tt%--ook---tt-%--------%tt--------------tt%%%%%-%%%%---@o-----
M-----y-%%%%---%%tt------%%%%TTy------%--tt--%%%%TT%%-%-%%tty-%%%-------%%%tt-%%%%------tt%--oo%---ttk%--------%ttk----y--%%%%%%tt%%%%%-%%%%----------
XXXXXXXXXXXXXXXXXXXXXXXXXXXXXXXXXXXXXXXXXXXXXXXXXXXXXXXXXXXXXXXXXXXXXXXXXXXXXXXXXXXXXXXXXXXXXXXXXXXXXXXXXXXXXXXXXXXXXXXXXXXXXXXXXXXXXXXXXXXX--XXXXXXXX
XXXXXXXXXXXXXXXXXXXXXXXXXXXXXXXXXXXXXXXXXXXXXXXXXXXXXXXXXXXXXXXXXXXXXXXXXXXXXXXXXXXXXXXXXXXXXXXXXXXXXXXXXXXXXXXXXXXXXXXXXXXXXXXXXXXXXXXXXXXX--XXXXXXXX
