------------------------------------------------------------------------------------------------------------------------------------------------------
------------------------------------------------------------------------------------------------------------------------------------------------------
------------------------------------------------------------------------------------------------------------------------------------------------------
------------------------------------------------------------------------------------------------------------------------------------------------------
------------------------------------------------------------------------------------------------------------------------------------------------------
------------------------------------------------------------------SSSS-------CC-----------------------------------------------------------------------
-------------------------ooooo----------------------------------------------------------------------------------oooo----------------------------------
--------!!!!-------------ooooo--------oooo----------------------------------------------------------------------ooooSSSSS-----------------------------
--ooooo-------------------------!!!---oooo----------oooo--------------ooo----------------U--------------oo----UU------------------ooo--------@@ooooo--
--ooooo-----o-------------------------oooo----------oooo--------------ooo------------ooo--y------oo-ooo-oo-ooo----------------------------------------
----------tto----------%%%%--------------------%----oooo---%%---------ooo---%%%%oo--------tt-----oo-----oo-ooott-%-------------------goooo------------
------%%%%tto------%---%%%%---Cy------tt-------%*----------%%--ooo-tt-------%%%%oo-LL-----tt---------------ooott-%-----------------%%%%-%--------tt---
------%%%%tt-------%---%%%%----tt-----tt---tt--%*--U-------%%-----%tt-------%%%%--------r-tt%----%---%-r--k---tt-%----%%%--tt------%%%%-%tt------tt---
Mg----%%%%tt------k%---%%%%----tt--gg%tt---tt--%*----------%%-----%tt----r--%%%%--g%%%%%%%tt%---r%-k-%-%%%%%%%tt-%----%%%--tt%---y-%%%%-%tt-g----tt-k-
XXXXXXXXXXXXXXXXXXXXXXXXXXXXXXXXXXXXXXXXXXXXXXXXXXXXXXXXXXXXXXXXXXXXXXXXXXXXXXXXXXXXXXXXXXXXXXXXXXXXXXXXXXXXXXXXXXXXXXXXXXXXXXXXXXXXXXXXXXXXXXXXXXX---
XXXXXXXXXXXXXXXXXXXXXXXXXXXXXXXXXXXXXXXXXXXXXXXXXXXXXXXXXXXXXXXXXXXXXXXXXXXXXXXXXXXXXXXXXXXXXXXXXXXXXXXXXXXXXXXXXXXXXXXXXXXXXXXXXXXXXXXXXXXXXXXXXXX---
