------------------------------------------------------------------------------------------------------------------------------------------------------
------------------------------------------------------------------------------------------------------------------------------------------------------
------------------------------------------------------------------------------------------------------------------------------------------------------
------------------------------------------------------------------------------------------------------------------------------------------------------
-----o@@@@-------------CCCC---------------------------------------------------------------------------------------------------------------------------
-----o-----------------------------------------------------------------------------------------------------------------------------------ooooo--------
-----o-----L-----------------------------------------------------------------------------------------------------SSSS----CC-o------------ooooo--------
--------------------------------------------oooo-------------------------------------------------------ooooo----------ooo---o-ooooo-------------------
-------------oooooooooo---------------------ooooUUUUooooo-----------------------------------oooo-------ooooo-ooo------ooo--o--ooooo-----------LLLLL---
----------y--------------------r--------g---oooo----------------oo-------------------------------------ooooo-ooo------ooo----rooooo----------------r--
-----%%--%tt--------%%%%%%%%--%%--------tt-------*--------------oo----------tt------------------@@@@@--------ooo-----g-----%%%%------tt----%-------%-%
-----%%tt%tt--------%%%%%%%%--%%--------tt-------*--%%%%%tt-----oo!!--------tt--------tt-------------o---------------tt----%%%%------tt----%tt-----%-%
-----%%tt%tt--------%%%%%%%%--%%--------tt----tt-*--%%%%%tt-----------------tt-oo-----tt----tt-------oy----------%%%%tt%%%-%%%%------tt----%tt-----%-%
M-r-g%%tt%tty-------%%%%%%%%--%%-----%--tt----tt-*--%%%%%tt%%%%%%%-------%%%ttroog----tt---ytt%------o%%%---g--%r%%%%tt%%%-%%%%------tt-g--%tt--%--%-%
XXXXXXXXXXXXXXXXXXXXXXXXXXXXXXXXXXXXXXXXXXXXXXXXXXXXXXXXXXXXXXXXXXXXXXXXXXXXXXXXXXXXXXXXXXXXXXXXXXXXXXXXXXXXXXXXXXXXXXXXXXXXXXXXXXXXXXX---XXXXXXX--XXX
XXXXXXXXXXXXXXXXXXXXXXXXXXXXXXXXXXXXXXXXXXXXXXXXXXXXXXXXXXXXXXXXXXXXXXXXXXXXXXXXXXXXXXXXXXXXXXXXXXXXXXXXXXXXXXXXXXXXXXXXXXXXXXXXXXXXXXX---XXXXXXX--XXX
