------------------------------------------------------------------------------------------------------------------------------------------------------
------------------------------------------------------------------------------------------------------------------------------------------------------
------------------------------------------------------------------------------------------------------------------------------------------------------
------------------------------------------------------------------------------------------------------------------------------------------------------
------------------------------------------------------------------------------------------------------------------------------------------------------
------------------------------------------------------------------------------------------------------------------------------------------------------
---------------------------------------LLLLL------------------@@@@@@----------------------------------------------------------oooo--------------------
-----------ooooo---------------------o-------------------------------------@@@ooo--ooo---!!!!!!!!!!---------------------------oooo--------------------
----------------------------@@@@@@@@@---------------------------------@@------ooo--ooo-oo-----------------------------------------------------oo------
-----------------------ooo-------------------------------ooooo-----------oo------@@ooo--------------------------------r----------------ooo----oo------
---oooo-oo-%%%%%%------ooo-o----------r--tt--------------ooooo%%%%%-oo---oo-----------------------------------------%o%%---------------%%-----oo------
--------oo-%%%%%%----------------%%%%%%%-tt--ooooo-----------%%%%%%--tt-----%%%%%--------------%%%%%%%%--------tt---%o%%-----tt--------%%-tt----------
---%%------%%%%%%----%----@--%%%-%%%%%%%-tt--ooooo---%%------%%%%%%--tt-----%%%%%%-----tt%%%-TT%%%%%%%%--@@@---tt-tt%-%%-%%--tt--------%%-tt%---r--%-o
M-g%%--r--g%%%%%%----%r------%%%-%%%%%%%-tt-k----%%--%%------%%%%%%--tt-r---%%%%%%--%%gtt%%%-TT%%%%%%%%-r------tt-tt%-%%-%%--tt---g----%%-tt%-%%%--%--
XXXXXXXXXXXXXXXXXXXXXXXXXXXXXXXXXXXXXXXXXXXXXXXXXXXXXXXXXXXXXXXXXXXXXXXXXXXXXXXXXXXXXXXXXXXXXXXXXXXXXXXXXXXXXXXXXXXXXXXXXXXXXXXXXXXXXXXXXXXXXXXXX--XXX
XXXXXXXXXXXXXXXXXXXXXXXXXXXXXXXXXXXXXXXXXXXXXXXXXXXXXXXXXXXXXXXXXXXXXXXXXXXXXXXXXXXXXXXXXXXXXXXXXXXXXXXXXXXXXXXXXXXXXXXXXXXXXXXXXXXXXXXXXXXXXXXXX--XXX
