------------------------------------------------------------------------------------------------------------------------------------------------------
------------------------------------------------------------------------------------------------------------------------------------------------------
------------------------------------------------------------------------------------------------------------------------------------------------------
----------------------------------------------------------------------------------------------------------o-------------------------------------------
------------------------------------------------------------------------------------------tt%%----------%%---tt---gg----------------------------------
------------------------------------------------y---------------------%%------------tt----tt||----------||---tt-%%%%%%--------------------------------
-----------------------------------------------%%%--------------------||------------tt----tt||-tt-------||---tt-||||||--------------------------------
----------------GY--g--------------------------|||--------------------||------------tt----tt||-tt-------||-o-tt-||||||---tt--------tt-------tt--------
------------%%%%%%%%%%%%%%---------------------|||--------------------||--oXXXXXXXXXXXXXXXXXXXXXXXXX----||XXXXXX||||||---tt--------tt-------tt--------
-----------tt|||||||||||||----------o----------|||o-----Ggo-----------||---XXXXXXXXXXXXXXXXXXXXXXXXX----||XXXXXXtt||||---tt--------tt-------tt---Fo---
-----------tt||||||||||tt|----o---------tt-----|||-----%%%%%%%-o------||---XXXXXXXXXXXXXXXXXXXXXXXXX----||XXXXXXtt||||---tt----XXXXXX------XXXXXXXX---
-----------tt||||||||||tt|-----o----g---tt-----|||-----|||||||-tt---G-||y--XXXXXXXXXXXXXXXXXXXXXXXXX----||XXXXXXXXXXXXXXXXXXXXXXXXXXX------XXXXXXXXo--
XXXXXXXXXXXXXXXXXX|tt||tt|-tt------%%%%%tt-----|||-----||tt|||-tt---XXXXXXXXXXXXXXXXXXXXXXXXXXXXXXXX-o--||XXXXXXXXXXXXXXXXXXXXXXXXXXX------XXXXXXXX---
XXXXXXXXXXXXXXXXXX|tt||tt|-tt--G---|||||tt-----|||---o-||tt|||-tto--XXXXXXXXXXXXXXXXXXXXXXXXXXXXXXXX---tt|XXXXXXXXXXXXXXXXXXXXXXXXXXX------XXXXXXXXtt-
XXXXXXXXXXXXXXXXXXXXXXXXXXXXXXXXXttXXXXXXXXXXXXXXXXXXXXXXXXXXXXXXXXXXXXXXXXXXXXXXXXXXXXXXXXXXXXXXXXX---tt|XXXXXXXXXXXXXXXXXXXXXXXXXXX------XXXXXXXXtt-
XXXXXXXXXXXXXXXXXXXXXXXXXXXXXXXXXttXXXXXXXXXXXXXXXXXXXXXXXXXXXXXXXXXXXXXXXXXXXXXXXXXXXXXXXXXXXXXXXXX--gtt|XXXXXXXXXXXXXXXXXXXXXXXXXXX-----oXXXXXXXXtt-
