-----------------------------------------------------------------------------------------------------------------------------------------------------F
-----------------------------------------------------------------------------------------------------------------------------------------------------F
-----------------------------------------------------------------------------------------------------------------------------------------------------F
-----------------------------------------------------------------------------------------------------------------------------------------------------F
-------------------------------------------------------------------------------------------------------XXXXXXX---------------------------------------F
-------------------------------------------------------------------------------------------------------XXXXXXXXXXXXXXXXXXXXXX------------------------F
--------------------------------------------------------------------------------------------XXXXXXX----XXXXXXXXXXXXXXXXXXXXXX------------------------F
--------------------------------------------------------------------------------------------XXXXXXX----XXXXXXXXXXXXXXXXXXXXXX------------------------F
--------------------------------------------------------------------------------------------XXXXXXX----XXXXXXXXXXXXXXXXXXXXXXXXXXXXXXXXXXXXXXXXXXXXXXF
---------------------------------------------------------------------------------XXXXXXXXX--XXXXXXX----XXXXXXXXXXXXXXXXXXXXXXXXXXXXXXXXXXXXXXXXXXXXXXF
---------------------------------------------------------------------------------XXXXXXXXX--XXXXXXX----XXXXXXXXXXXXXXXXXXXXXXXXXXXXXXXXXXXXXXXXXXXXXXF
--------XXXXXXXXXXXXXXXXX---XXXXXXXXXXXXXXXXXXXXX----XXXXXXXXXXXXXXXXXXXXXXXXXXXXXXXXXXXXX--XXXXXXX----XXXXXXXXXXXXXXXXXXXXXXXXXXXXXXXXXXXXXXXXXXXXXXF
XXXXX---XXXXXXXXXXXXXXXXX---XXXXXXXXXXXXXXXXXXXXX----XXXXXXXXXXXXXXXXXXXXXXXXXXXXXXXXXXXXX--XXXXXXX----XXXXXXXXXXXXXXXXXXXXXXXXXXXXXXXXXXXXXXXXXXXXXXX
XXXXX---XXXXXXXXXXXXXXXXX---XXXXXXXXXXXXXXXXXXXXX----XXXXXXXXXXXXXXXXXXXXXXXXXXXXXXXXXXXXX--XXXXXXX----XXXXXXXXXXXXXXXXXXXXXXXXXXXXXXXXXXXXXXXXXXXXXXX
XXXXX---XXXXXXXXXXXXXXXXX---XXXXXXXXXXXXXXXXXXXXX----XXXXXXXXXXXXXXXXXXXXXXXXXXXXXXXXXXXXX--XXXXXXX----XXXXXXXXXXXXXXXXXXXXXXXXXXXXXXXXXXXXXXXXXXXXXXX
XXXXX---XXXXXXXXXXXXXXXXX---XXXXXXXXXXXXXXXXXXXXX----XXXXXXXXXXXXXXXXXXXXXXXXXXXXXXXXXXXXX--XXXXXXX----XXXXXXXXXXXXXXXXXXXXXXXXXXXXXXXXXXXXXXXXXXXXXXX
